Цієї	      pron:f_rod 
п'ятниці	  noun:f:v_rod  
з	          prep:rv_rod:rv_zna:rv_oru 
задоволенням  noun:n:v_oru 
замовила	  verb:past:f:perf 
сет	          noun:m:v_zna 
із	          prep:rv_rod:rv_zna:rv_oru 
собою	      pron:refl:m:v_oru                       
зробили	      verb:past:p:perf 
швидко	      adv:compb 
і	          conj:coord 
у	          prep:rv_zna:rv_mis:rv_rod:v-u 
вартість	  noun:f:v_zna 
як	          adv:&pron:int:rel 
мені	      pron:pers:s:1:v_dav:anim 
здалося	      verb:rev:past:n:perf 
навіть	      part 
не	          part 
включили	  verb:past:p:perf:v-u 
упаковку	  noun:f:v_zna  
сет	          noun:m:v_naz  
дуже	      adv  
сподобався	  verb:rev:past:m:perf 
брали	      verb:past:p:imperf 
за	          prep:rv_rod:rv_zna:rv_oru 
169	          number 
грн	          noun:p:v_zna:nv:abbr 
тільки	      conj:subord 
от	          part 
вино	      noun:n:v_naz 
з	          prep:rv_rod:rv_zna:rv_oru 
собою	      pron:refl:n:v_oru 
у	          prep:rv_zna:rv_mis:rv_rod:v-u 
пластику	  noun:m:v_mis 
не	          part 
дуже	      adv 
виглядало	  verb:past:n:imperf 
А	          conj:coord  
загалом	      adv 
за	          prep:rv_rod:rv_zna:rv_oru
сервіс	      noun:m:v_zna 
та	          conj:coord 
сушки	      noun:p:v_zna 
ставлю	      verb:pres:s:1:imperf 
5	5         number 
Насправді	  adv 
власники	  noun:p:v_naz:anim 
закладів	  noun:p:v_rod (zna) 
мережі	      noun:p:v_zna 
платять	      verb:pres:p:3:imperf 
не	          part 
стільки	      numr:p:v_zna:&pron:ind 
за	          prep:rv_rod:rv_zna:rv_oru
ім'я	      noun:n:v_zna 
скільки	      numr:p:v_zna:&pron:ind 
за	          prep:rv_rod:rv_zna:rv_oru
організацію	  noun:f:v_zna 
всього	      adj:m:v_rod:&pron:dem                           
ресторанного  adj:m:v_rod                             
Той	          adj:m:v_naz:&pron:dem         
факт	      noun:m:v_naz 
що	          conj:subord  
таки	      part 
платять	      verb:pres:p:3:imperf 
натякає	      verb:pres:s:3:imperf 
нам	          pron:pers:p:1:v_dav:anim
на	          prep:rv_zna:rv_mis 
цього         adj:n:v_rod:&pron:dem 
проекту	      noun:m:v_rod 
А	          conj:coord 
успішність	  noun:f:v_naz                        
без	          prep:rv_rod 
клієнтів	  noun:p:v_zna:anim 
Зазвичай	  adv 
на	          prep:rv_zna:rv_mis 
проспекті	  noun:m:v_mis 
Шевченка	  noun:m:v_rod:anim:lname 
зайнята	      adjp:pasv:past:f:v_naz 
але	          conj:coord 
в	          prep:rv_zna:rv_mis:rv_rod:v-u 
центрі	      noun:m:v_mis 
куди	      adv:&pron:int:rel 
варто	      predic 
ходити	      verb:inf:imperf 
пішки	      adv 
це	          adj:n:v_naz:&pron:dem 
не	          part 
проблема	  noun:f:v_naz 
ілюмінація	  noun:f:v_naz 
нового	      adj:m:v_zna:compb 
ресторанчику  noun:m:v_mis 
здорово	      adv:compb 
освіжила	  verb:past:f:perf 
фасад	      noun:m:v_zna 
похмурої	  adj:f:v_rod:compb 
профспілкової adj:f:v_rod 
будівлі	      noun:f:v_dav 
З	          prep:rv_rod:rv_zna:rv_oru 
увагою	      noun:f:v_oru 
до	          prep:rv_rod 
нових	      adj:p:v_zna:compb 
відвідувачів  noun:p:v_zna:anim 
в	          prep:rv_zna:rv_mis:rv_rod:v-u 
них	          pron:pers:p:3:v_mis:anim 
все	          adj:n:v_zna:&pron:dem 
гаразд        noun:m:v_zna 
зустрінуть	  verb:futr:p:3:perf 
підберуть	  verb:futr:p:3:perf 
столик	      noun:m:v_zna 
запропонують  verb:futr:p:3:perf 
меню	      noun:n:v_zna:nv  
І	          conj:coord 
потім	      adv:&pron:dem 
вам	          pron:pers:p:2:v_dav:anim
залишають	  verb:pres:p:3:imperf 
дзвінок	      noun:m:v_zna
на	          prep:rv_zna:rv_mis 
столику	      noun:m:v_mis 
аби	          conj:subord 
ця	          adj:f:v_naz:&pron:dem 
увага	      noun:f:v_naz 
не	          part 
була	      verb:past:f:imperf 
втрачена	  adjp:pasv:past:f:v_naz:v-u 
протягом	  noun:m:v_oru 
вечора	      noun:m:v_rod 
Отже	      part 
були	      verb:past:p:imperf 
та	          conj:coord  
то	          conj:subord 
сервісу	      noun:m:v_dav  
на	          prep:rv_zna:rv_mis 
користь	      noun:f:v_zna 
В	          prep:rv_zna:rv_mis:rv_rod:v-u 
ресторанчику  noun:m:v_mis 
однозначно	  adv 
симпатично	  adv:compb 
і	          conj:coord  
комфортно	  adv:compb 
Хіба	      part 
якщо	      conj:subord 
деякі	      adj:p:v_naz
столики	      noun:p:v_naz 
здаються	  verb:rev:pres:p:3:imperf 
вам	          pron:pers:p:2:v_dav:anim
занадто	      adv 
близько	      adv:compb 
розміщеними	  adjp:pasv:past:p:v_oru 
можу	      verb:unknown 
рекомендувати verb:inf:imperf 
бронювати	  verb:inf:imperf 
дивани	      noun:p:v_zna 
Ніщо	      pron:neg:v_naz 
в	          prep:rv_zna:rv_mis:rv_rod:v-u 
інтер'єрі	  noun:m:v_mis 
цього	      adj:n:v_rod:&pron:dem 
ресторану	  noun:m:v_rod 
не	          part 
вибивається	  verb:rev:pres:s:3:imperf 
з	          prep:rv_rod:rv_zna:rv_oru 
обраної	      adjp:pasv:past:f:v_rod 
стилістики	  noun:f:v_rod 
і	          conj:coord  
не	          part 
дратує	      verb:pres:s:3:imperf 
мережеві	  adj:p:v_zna 
заклади	      noun:p:v_zna        
дійсно	      adv 
відпрацьовують verb:pres:p:3:imperf 
з	          prep:rv_rod:rv_zna:rv_oru 
дизайнерами	  noun:p:v_oru:anim 
красу	      noun:f:v_zna 
А	          part 
притаманні	  adj:p:v_naz 
Мафії	      noun:f:v_dav 
величезні	  adj:p:v_naz 
вікна	      noun:p:v_naz 
приваблюють	  verb:pres:p:3:imperf 
до	          prep:rv_rod 
та	          conj:coord 
поодиноких	  adj:p:v_zna 
відвідувачів  noun:p:v_zna:anim 
що	          pron:int:rel:n:v_zna 
полюбляють	  verb:pres:p:3:imperf 
милуватися	  verb:rev:inf:imperf 
старим	      adj:m:v_oru:compb 
Львовом	      noun:m:v_oru 
вдень	      adv:v-u 
І	          conj:coord 
це	          adj:n:v_naz:&pron:dem
попри	      prep:rv_zna 
те	          adj:n:v_zna:&pron:dem
що	          conj:subord 
концепт	      noun:m:v_naz 
ресторану	  noun:m:v_rod 
сімейний	  adj:m:v_naz 
Справді	      adv 
тут	          adv:&pron:dem 
нерідко	      adv 
відпочивають  verb:pres:p:3:imperf 
родинами	  noun:p:v_oru 
вкупі	      adv:v-u 
з	          prep:rv_rod:rv_zna:rv_oru
галасливою	  adj:f:v_oru 
малечею	      noun:f:v_oru 
Ще	          part 
частими	      adj:p:v_oru:compb 
відвідувачами noun:p:v_oru:anim 
є	          verb:pres:s:3:imperf 
туристи	      noun:p:v_naz:anim 
та	          conj:coord 
студенти	  noun:p:v_naz:anim 
Заклад	      noun:m:v_naz 
з	          prep:rv_rod:rv_zna:rv_oru
італійською	  adj:f:v_oru 
та	          conj:coord 
японською	  adj:f:v_oru 
кухнями	      noun:p:v_oru 
швидко	      adv:compb 
став          verb:past:m:perf 
відомим	      adj:m:v_oru:compb  
Чим	          pron:int:rel:n:v_oru 
викликана	  adjp:pasv:past:f:v_naz 
така	      adj:f:v_naz:&pron:def 
популярність  noun:f:v_zna 
Добрими	      adj:p:v_oru:compb 
стравами	  noun:p:v_oru 
І	          conj:coord 
взагалі	      adv:v-u 
відтепер	  adv:&pron:dem 
саме	      part
в	          prep:rv_zna:rv_mis:rv_rod:v-u 
Мафії	      noun:f:v_mis 
найсмачніша	  adj:f:v_naz:super 
піца	      noun:f:v_naz 
А	          conj:coord 
екзотичні	  adj:p:v_naz:compb 
поєднання	  noun:n:v_naz
наприклад	  insert 
з	          prep:rv_rod:rv_zna:rv_oru
малосольною	  adj:f:v_oru 
рибою	      noun:f:v_oru:anim 
виявляються	  verb:rev:pres:p:3:imperf 
більш	      adv:compr 
ніж	          conj:subord 
вдалими	      adj:p:v_oru:compb:v-u 
І	          conj:coord 
це	          adj:n:v_naz:&pron:dem
дифірамби	  noun:p:v_zna 
від	          prep:rv_rod 
їжі	          noun:f:v_rod 
зразка	      noun:m:v_rod 
Великі	      adj:p:v_naz:compb 
компанії	  noun:p:v_naz
ж	          conj:coord 
підкупляють	  verb:pres:p:3:imperf 
гігантськими  adj:p:v_oru 
піцами	      noun:p:v_oru 
на	          prep:rv_zna:rv_mis 
весь	      adj:m:v_zna:&pron:dem
стіл	      noun:m:v_zna 
Ну	          part 
і	          conj:coord
бонусами	  noun:p:v_oru 
від	          prep:rv_rod 
закладу	      noun:m:v_rod 
в	          prep:rv_zna:rv_mis:rv_rod:v-u 
тому	      conj:subord  
числі	      noun:n:v_mis 
алкогольними  adj:p:v_oru 
Салати	      noun:p:v_naz
пасти	      noun:p:v_naz 			  
лосось	      noun:m:v_naz:anim 
м'ясо	      noun:n:v_naz
десерти	      noun:p:v_naz  
можна	      predic 
обирати	      verb:inf:imperf 
в	          prep:rv_zna:rv_mis:rv_rod:v-u 
ілюстрованому adjp:pasv:past:n:v_mis 
меню	      noun:n:v_mis:nv 	         
Відповідність noun:f:v_naz 
дотримана	  adjp:pasv:past:f:v_naz 
А	          conj:coord
суші	      noun:p:v_zna 
окрім	      prep:rv_rod 
класичних	  adj:p:v_zna 
пропонують	  verb:pres:p:3:imperf 
також	      conj:coord 
з	          prep:rv_rod:rv_zna:rv_oru
мигдалем	  noun:m:v_oru 
або	          conj:coord 
апельсинами	  noun:p:v_oru 
Повечеряти	  verb:inf:perf 
загалом	      adv
можна	      predic  
як	          conj:subord 
за	          prep:rv_rod:rv_zna:rv_oru
60	          number 
грн	          noun:p:v_zna:nv:abbr 
так	          conj:coord:subord 
і	          conj:coord 
за	          prep:rv_rod:rv_zna:rv_oru
200	          number 
Присутні	  adj:p:v_naz
пропозиції	  noun:p:v_naz 
на	          part 
будь-який	  adj:m:v_zna:&pron:ind 
гаманець	  noun:m:v_zna 
Принаймні	  adv 
поки	      сonj:subord
що	          conj:subord 
Тому	      conj:subord
поспішайте	  verb:impr:p:2:imperf 
і	          conj:coord 
сподіваюсь	  verb:rev:pres:s:1:imperf
що	          conj:subord 
вільні	      adj:p:v_zna:compb 
місця	      noun:p:v_zna 
ще	          part 
можна	      predic 
буде	      verb:futr:s:3:imperf 
застати	      verb:inf:perf  
І	          conj:coord 
так	          part 
там	          adv:&pron:dem 
ще	          part 
є	          verb:pres:s:3:imperf
караоке	      noun:n:v_naz:nv:np 
Замовляли	  verb:past:p:imperf 
картоплю	  noun:f:v_zna 
по-середземноморському	 adv 
та	           conj:coord 
стейк-мікс	   noun:m:v_zna 
Смачно	       adv:compb 
Салат	       noun:m:v_naz 
Цезар	       noun:m:v_naz 
соус	       noun:m:v_naz 
був	           verb:past:m:imperf 
роздвоєний	   adjp:pasv:past:m:v_naz
Піцу	       noun:f:v_zna 
замовили	   verb:past:p:perf 
одну	       numr:f:v_zna 
оператор	   noun:m:v_naz:anim 
погодив	       verb:past:m:perf 
замовлення	   noun:n:v_zna  
згодом	       adv 
щоб	           conj:subord 
замінити	   verb:inf:perf 
на	           prep:rv_zna:rv_mis 
іншу	       adj:f:v_zna:&pron:def  
замінили	   verb:past:p:perf 
згодом	       adv 
знову	       adv 
нам	           pron:pers:p:1:v_dav:anim
і	           conj:coord 
знову	       adv 
попросили	   verb:past:p:perf 
замінити	   verb:inf:perf 
на	           prep:rv_zna:rv_mis 
іншу	       adj:f:v_zna:&pron:def 
Загалом	       adv 
двояке	       adj:n:v_naz 
враження	   noun:n:v_naz 
від	           prep:rv_rod 
сервісу	       noun:m:v_dav
та	           conj:coord 
кухні	       noun:f:v_dav 
Замовляв	   verb:past:m:imperf 
суші	    	 noun:p:v_zna  (суші )
в	           prep:rv_zna:rv_mis:rv_rod:v-u 
смачно	       adv:compb 
але	           conj:coord
здивувало	   verb:past:n:perf 
яку	           adj:f:v_zna:&pron:int:rel:def 
кількість	   noun:f:v_zna 
соєвого	       adj:m:v_zna
соусу	       noun:m:v_rod 
іде	           verb:pres:s:3:imperf 
в	           prep:rv_zna:rv_mis:rv_rod:v-u 
придачу	       noun:f:v_zna:np 
до	           prep:rv_rod 
товару	       noun:m:v_dav
дуже	       adv 
мала	       adj:f:v_naz:compb
кількість	   noun:f:v_naz 
те	           adj:n:v_naz:&pron:dem 
саме	       part  
і	           conj:coord 
з	           prep:rv_rod:rv_zna:rv_oru 
імбиром	       noun:m:v_oru 
Або	           conj:coord 
закінчувався   verb:rev:past:m:imperf 
соус	       noun:m:v_naz 
або	           conj:coord 
шеф	           noun:m:v_naz:anim 
був	           verb:past:m:imperf 
накурений	   adjp:pasv:past:m:v_naz
Обслуговування noun:n:v_naz 
на	           prep:rv_zna:rv_mis 
2	           number 
Один	       numr:m:v_naz 
пафос	       noun:m:v_naz 
страви	       noun:p:v_naz
так	           adv:&pron:dem
собі	       pron:refl:m:v_dav 
ціни	       noun:p:v_naz 
шалені	       adj:p:v_naz 
обслуговування noun:n:v_naz
цілковитий	   adj:m:v_naz 
0	           number 

Жах	           noun:m:v_naz 
Добрий	       adj:m:v_naz:compb 
день	       noun:m:v_naz 
Мали	       verb:past:p:imperf 
нагоду	       noun:f:v_zna 
відпочивати	   verb:inf:imperf 
в	           prep:rv_zna:rv_mis:rv_rod:v-u 
цьому	       adj:m:v_mis:&pron:dem 
закладі	       noun:m:v_mis 
в	           prep:rv_zna:rv_mis:rv_rod:v-u 
караоке-залі   noun:m:v_mis
Нас	           pron:pers:p:1:v_zna:anim
було	       verb:past:n:imperf 
семеро	       numr:p:v_zna 
людей	       noun:p:v_zna:anim 
що	           pron:int:rel:n:v_naz
дозволяло	   verb:past:n:imperf 
нам	           pron:pers:p:1:v_dav:anim
співати	       verb:inf:imperf 
тільки	       part 
одну	      numr:f:v_zna 
пісню	      noun:f:v_zna 
від	          prep:rv_rod 
столика	      noun:m:v_rod 
тому	     conj:subord 
ми	         pron:pers:p:1:v_naz:anim
доплатили	 verb:past:p:perf 
за	         prep:rv_rod:rv_zna:rv_oru
8	         number 
людину	     noun:f:v_zna:anim 
щоб	         conj:subord 
могти	     verb:inf:unknown 
співати	     verb:inf:imperf 
більше	     adv:compr 
2	         number 
пісні	     noun:p:v_zna 
З	         prep:rv_rod:rv_zna:rv_oru
цього	     adj:m:v_rod:&pron:dem 
і	         part 
почалось	 verb:rev:past:n:perf  
Сусідньому	 adj:m:v_dav
столику	     noun:m:v_dav
який	     adj:m:v_naz:&pron:int:rel:def
також	     conj:coord 
мав	         verb:past:m:imperf 
співати	     verb:inf:imperf 
по	         prep:rv_mis:rv_zna 
2	         number 
пісні	     noun:p:v_zna 
чомусь	     adv:&pron:ind 
щось        pron:ind:n:v_dav 
дозволялось	verb:rev:past:n:imperf 
співати	    verb:inf:imperf 
3	        number 
пісні	    noun:p:v_zna 
Коли	    conj:subord 
ми	        pron:pers:p:1:v_naz:anim 
підняли	    verb:past:p:perf 
це	        adj:n:v_zna:&pron:dem 
питання		noun:n:v_zna
то	        conj:subord 
менеджер	noun:m:v_naz:anim 
караоке-залу noun:m:v_rod 
Володимир	 noun:m:v_naz:anim:fname
не	        part 
зовсім	    adv 
привітно    adv:compb 
з	        prep:rv_rod:rv_zna:rv_oru 
нами	    pron:pers:p:1:v_oru:anim 
розмовляв   verb:past:m:imperf 
тому	    conj:subord
прийшлось   verb:rev:past:n:perf 
покликати	verb:inf:imperf 
адміністратора  noun:m:v_zna:anim 
ресторану	    noun:m:v_rod 
Адміністратором	 noun:m:v_oru:anim 
виявилась	     verb:rev:past:f:perf 
дівчина	         noun:f:v_naz:anim 
Мар'яна	        noun:f:v_naz:anim:fname 
яка	          adj:f:v_naz:&pron:int:rel:def 
ніяким	      adj:m:v_oru:&pron:neg  
чином	      noun:m:v_oru 
і	          conj:coord 
не	          part 
збиралась	  verb:rev:past:f:imperf 
вирішувати	  verb:inf:imperf 
конфліктної	  adj:f:v_rod:compb 
ситуації	  noun:f:v_rod 
а	          conj:coord 
відверто	  adv:compb 
стояла	     verb:past:f:imperf 
та	          conj:coord 
нам	          pron:pers:p:1:v_dav:anim 
в	          prep:rv_zna:rv_mis:rv_rod:v-u 
Нашу	     adj:f:v_zna:&pron:pos 
розмову	     noun:f:v_zna 
з	         prep:rv_rod:rv_zna:rv_oru 
адміністратором	 noun:m:v_oru:anim 
ми	         pron:pers:p:1:v_naz:anim 
знімали	     verb:past:p:imperf 
на	         prep:rv_zna:rv_mis 
відео	     noun:n:v_mis:nv 
що	         conj:subord 
є	         verb:pres:s:3:imperf 
дозволено	 verb:impers:perf 
законодавством	 noun:n:v_oru 
України	      noun:f:v_rod  
посеред	      prep:rv_rod 
зйомки	      noun:f:v_rod 
у	          prep:rv_zna:rv_mis:rv_rod:v-u 
нас	          pron:pers:p:1:v_mis:anim 
без	          prep:rv_rod 
жодних	     adj:p:v_rod:&pron
пояснень	 noun:p:v_rod 
забрав	     verb:past:m:perf 
телефон	      noun:m:v_zna 
менеджер	  noun:m:v_naz:anim 
караоке-залу  noun:m:v_rod 
Володимир	  noun:m:v_naz:anim:fname 
Через	      prep:rv_zna 
декілька	  numr:p:v_zna:&pron:ind
хвилин	      noun:p:v_rod 
телефон	      noun:m:v_zna 
знову	      adv 
ж	          part 
таки	      part 
без	          prep:rv_rod 
пояснень	  noun:p:v_rod 
чи	          conj:coord:subord 
вибачень	  noun:p:v_rod 
поклали	      verb:past:p:perf 
на	          prep:rv_zna:rv_mis 
сусідній	  adj:m:v_zna 
столик	      noun:m:v_zna  
Менеджер	  noun:m:v_naz:anim 
караоке-залу  noun:m:v_rod
Володимир	  noun:m:v_naz:anim:fname
протягом	  noun:m:v_oru 
нашої	      adj:f:v_rod:&pron:pos 
розмови	      noun:f:v_rod  
дозволяв	  verb:past:m:imperf 
собі	      pron:refl:m:v_dav 
хамські	      adj:p:v_zna 
висловлювання  noun:p:v_zna 
та	          conj:coord 
доволі	      adv 
неадекватну	  adj:f:v_zna 
поведінку	  noun:f:v_zna 
Одним	      numr:n:v_oru 
словом	      noun:n:v_oru 
однозначно	  adv 
рівень	      noun:m:v_naz
підготовки	  noun:f:v_rod 
персоналу	  noun:m:v_rod 
не	          part 
відповідає	  verb:pres:s:3:imperf 
рівню	      noun:m:v_dav 
закладу	     noun:m:v_rod 
Вважаю	     verb:pres:s:1:imperf 
що	         conj:subord
як	         part 
менеджер	 noun:m:v_naz:anim 
караоке-залу	 noun:m:v_rod  
Володимир	    noun:m:v_naz:anim:fname 
так	           part 
і	          conj:coord 
адміністратор noun:m:v_naz:anim 
закладу	     noun:m:v_rod 
мали	     verb:past:p:imperf 
б	         part 
бути	     verb:inf:imperf 
однозначно	 adv 
звільнені	 adjp:pasv:past:p:v_naz 
або	         conj:coord 
хоча	    part 
б	        part 
покарані	adjp:pasv:past:p:v_naz 
тому	    adv 
що	        conj:subord 
впевнена    adj:f:v_naz:compb:v-u:&adjp:pasv:past 
що	        conj:subord
такі	    adj:p:v_naz:&pron:def
ситуації     noun:p:v_naz 
будуть	    verb:futr:p:3:imperf 
виникати	 verb:inf:imperf 
та	         conj:coord
в	          prep:rv_zna:rv_mis:rv_rod:v-u 
майбутньому	 adj:n:v_mis 
Конфлікт	 noun:m:v_naz 
звісно	      adv 
почався	     verb:rev:past:m:perf 
з	         prep:rv_rod:rv_zna:rv_oru
дрібнички	 noun:p:v_zna 
але	         conj:coord 
подальше	 adj:n:v_naz 
спілкування	 noun:n:v_naz
з	         prep:rv_rod:rv_zna:rv_oru
адміністраторами	 noun:p:v_oru:anim 
просто	    adv:compb 
залишило	 verb:past:n:perf 
негативне	  adj:n:v_zna:compb 
враження	 noun:p:v_zna 
про	         prep:rv_zna 
цей	         adj:m:v_zna:&pron:dem 
заклад	   noun:m:v_zna 
Повернусь	 verb:rev:futr:s:1:perf 
туди	   adv:&pron:dem 
тільки	   adv  
для	       prep:rv_rod 
того	   adj:m:v_rod:&pron:dem 
щоб	       conj:subord 
перевірити  verb:inf:perf 
відповідь  noun:f:v_zna 
на	       prep:rv_zna:rv_mis 
запис	   noun:m:v_zna 
що	        pron:int:rel:n:v_zna 
я	         pron:pers:s:1:v_naz:anim 
залишила	 verb:past:f:perf 
в	         prep:rv_zna:rv_mis:rv_rod:v-u 
книзі	     noun:f:v_mis 
скарг	     noun:p:v_rod 
та	        conj:coord 
пропозицій	 noun:p:v_rod 
яка	         adj:f:v_naz:&pron:int:rel:def 
також	     conj:coord 
викликала	 verb:past:f:perf 
сумнів	     noun:m:v_zna 
книга	    noun:f:v_naz 
була	    verb:past:f:imperf 
заведена	 adjp:pasv:past:f:v_naz 
в	        prep:rv_zna:rv_mis:rv_rod:v-u 
переддень	  noun:m:v_zna 
виникнення	  noun:n:v_naz  
конфлікту	  noun:m:v_rod 
це	         adj:n:v_zna:&pron:dem 
пояснили	 verb:past:p:perf 
тим	         adj:m:v_oru:&pron:dem 
що	         pron:int:rel:n:v_naz
книги	     noun:f:v_rod 
закінчуються verb:rev:pres:p:3:imperf 
проте	   conj:coord 
показати   verb:inf:perf 
нам	       pron:pers:p:1:v_dav:anim 
попередню	 adj:f:v_zna 
книгу	     noun:f:v_zna 
відмовились	 verb:rev:past:p:perf 
Обов'язково	 adv 
звернусь	 verb:rev:futr:s:1:perf 
зі	         prep:rv_rod:rv_zna:rv_oru 
скаргою	     noun:f:v_oru 
в	         prep:rv_zna:rv_mis:rv_rod:v-u 
Управління	 noun:n:v_rod 
захисту	     noun:m:v_rod 
прав	     noun:p:v_rod
споживачів	 noun:p:v_rod:anim 
м	         noun:m:v_rod:nv:abbr
Львова	     noun:m:v_rod 
Такого	     adj:m:v_rod:&pron:def 
відношення	 noun:p:v_zna 
до	         prep:rv_rod 
клієнтів	 noun:p:v_rod:anim 
я	         pron:pers:s:1:v_naz:anim 
чесно	     adv:compb 
кажучи	     advp:imperf 
в	         prep:rv_zna:rv_mis:rv_rod:v-u 
інших	     adj:p:v_mis:&pron:def 
закладах	 noun:p:v_mis 
не	         part 
зустрічала	 verb:past:f:imperf 
Таке	     adj:n:v_naz:&pron:def 
відношення	 noun:n:v_naz
великий	     adj:m:v_naz:compb 
мінус	     noun:m:v_naz 
для	         prep:rv_rod 
закладу	     noun:m:v_rod
Сьогодні	 adv 
відвідали	 verb:past:p:perf 
Сам	         adj:m:v_naz:&pron:def
заклад	     noun:m:v_naz  
дуже	     adv
сподобався	 verb:rev:past:m:perf 
адже	     conj:subord 
поки	     adv:&pron:int:rel 
чекали	     verb:past:p:imperf 
замовлення	 noun:n:v_rod
то	         conj:subord 
і	         conj:coord 
діткам	     noun:p:v_dav:anim 
було	     verb:past:n:imperf 
не	         part 
сумно	    adv:compb 
бо	        conj:subord 
вони	    pron:pers:p:3:v_naz:anim 
розважались	 verb:rev:past:p:imperf 
в	        prep:rv_zna:rv_mis:rv_rod:v-u 
дитячій	    adj:f:v_mis 
кімнаті	    noun:f:v_mis 
і	        conj:coord
дорослим    noun:p:v_dav:anim 
справді	    part 
затишно	    adv:compb 
Атмосфера	 noun:f:v_naz 
загалом	     adv 
хороша	     adj:f:v_naz:compb 
От	        part 
лише	    part 
обслуговування	 noun:n:v_naz 
не	        part 
дуже	    adv
порадувало	 verb:past:n:perf 
Нас	         pron:pers:p:1:v_rod:anim
відверто	 adv:compb 
ігнорували	 verb:past:p:imperf 
хвилин	     noun:p:v_rod 
15	         number 
поки	     adv:&pron:int:rel 
не	         part 
прийняли	verb:past:p:perf 
замовлення	noun:p:v_zna 
Коли	    conj:subord 
забрали	    verb:past:p:perf 
попільничку	 noun:f:v_zna 
замінити	 verb:inf:perf 
то	         conj:subord 
забували	 verb:past:p:imperf 
її	          pron:pers:f:3:v_rod:anim
повернути	 verb:inf:perf 
також	     adv 
хвилин	     noun:p:v_rod 
25	         number 
Та	         conj:coord 
купа	     noun:f:v_naz 
інших	     adj:p:v_zna:&pron:def 
нюансів	     noun:p:v_rod 
щодо	     prep:rv_rod 
обслуговування	 noun:p:v_zna 
На	         prep:rv_zna:rv_mis 
мою	         adj:f:v_zna:&pron:pos 
думку	     noun:f:v_zna 
в	         prep:rv_zna:rv_mis:rv_rod:v-u 
такий	     adj:m:v_naz:&pron:def 
досить	     predic 
великий	     adj:m:v_naz:compb 
заклад	     noun:m:v_naz
варто	     predic 
було	     verb:past:n:imperf 
б	         part 
набрати	     verb:inf:perf 
трохи	     adv 
більше	     adv:compr 
персоналу	 noun:m:v_dav 
тоді	    adv:&pron:dem 
всі	        adj:p:v_zna:&pron:dem 
будуть	    verb:futr:p:3:imperf 
задоволені	 adj:p:v_naz:compb:&adjp:pasv:past
і	         conj:coord 
бідним	     adj:p:v_dav:compb 
офіціантам	 noun:p:v_dav:anim 
які	         adj:p:v_naz:&pron:int:rel:def 
не	         part 
встигають	 verb:pres:p:3:imperf:v-u 
бігати	     verb:inf:imperf 
від	         prep:rv_rod 
столика	     noun:m:v_rod
до	         prep:rv_rod 
столика	     noun:m:v_rod 
і	         conj:coord
клієнти	     noun:p:v_naz:anim 
будуть	    futr:p:3:imperf 
постійними	  adj:p:v_oru 
Я	          pron:pers:s:1:v_naz:anim
ніколи	      adv:&pron:neg 
не	          part 
пишу	      verb:pres:s:1:imperf 
скарги	      noun:p:v_zna 
але	          conj:coord 
Я	          pron:pers:s:1:v_naz:anim
ніколи	      adv:&pron:neg 
не	          part 
пишу	      verb:pres:s:1:imperf 
скарги	      noun:p:v_zna 
але	          conj:coord
заклад	      noun:m:v_naz 
викликав	  verb:past:m:perf 
таке	      adj:n:v_zna:&pron:def 
бажання	       noun:p:v_zna 
Піца	       noun:f:v_naz 
хороша	       adj:f:v_naz:compb 
персонал	   noun:m:v_naz 
приємний	   adj:m:v_naz:compb 
Другий	      adj:m:v_naz 
раз	           noun:m:v_naz 
прийшли	       verb:past:p:perf 
з	           prep:rv_rod:rv_zna:rv_oru 
іноземним	  adj:m:v_oru 
гостем	       noun:m:v_oru:anim 
замовили	  verb:past:p:perf 
набір	       noun:m:v_zna 
суші	       noun:p:v_zna 
несмачні	  adj:p:v_zna 
не	            part 
було	       verb:past:n:imperf 
вказано	       verb:impers:perf:v-u 
з	           prep:rv_rod:rv_zna:rv_oru 
чим	           pron:int:rel:n:v_oru 
вони	       pron:pers:p:3:v_naz:anim 
в	           prep:rv_zna:rv_mis:rv_rod:v-u 
меню	       noun:n:v_mis:nv
не	           part 
тільки	       adv 
не	           part 
відповідали	   verb:past:p:imperf 
картинці	    noun:f:v_dav 
а	            conj:coord 
і	            conj:coord 
виглядали	    verb:past:p:imperf 
втомилися	     verb:rev:past:p:perf:v-u 
столи	      noun:p:v_naz
були	      verb:past:p:imperf 
брудні	      adj:p:v_naz:compb 
Третій	      adj:m:v_naz 
раз	          noun:m:v_naz 
не	          part 
ризикнемо	 verb:futr:p:1:perf 
зайти	     verb:inf:perf 
Ресторан	 noun:m:v_naz 
Мафія	     noun:f:v_naz 
Пишете	    verb:pres:p:2:imperf 
дурниці	     noun:p:v_zna 
там	         adv:&pron:dem 
просто	     adv:compb 
чудово	     adv:compb 
надзвичайно	 adv 
все	         adv:v-u 
смачно	     adv:compb 
та	         conj:coord 
ідеально	 adv 
чисто	     adv:compb 
Це	         adj:n:v_naz:&pron:dem 
напевно	     adv 
пишуть	     verb:pres:p:3:imperf 
недосвідчені adj:p:v_naz 
та	         conj:coord
справжні	 adj:p:v_naz
хами	     noun:p:v_naz:anim 
які	         adj:p:v_naz:&pron:int:rel:def
справді	     adv
ніде	     adv:&pron:neg 
не	         part 
були	     verb:past:p:imperf 
та	         conj:coord 
нічого	     pron:neg:v_rod
не	         part 
бачили	     verb:past:p:imperf 
А	         conj:coord
в	         prep:rv_zna:rv_mis:rv_rod:v-u 
Мафії	     noun:f:v_mis  
все	         part:v-u 
справді	     adv
чудово	     adv:compb  
Дякуємо	      verb:pres:p:1:imperf 
Відстій	      noun:m:v_naz
може	     verb:unknown 
і	          conj:coord 
були	      verb:past:p:imperf 
але	          conj:coord 
ефект	      noun:m:v_naz 
дали	       verb:past:p:perf 
нетривалий	   adj:m:v_naz 
Персонал	   noun:m:v_naz 
і	           conj:coord
намагається    verb:rev:pres:s:3:imperf
надурити	    verb:inf:perf 
клієнт          noun:m:v_zna:anim 
Ігнорування	    noun:n:v_naz
замовлень	    noun:p:v_rod 
або	            conj:coord 
видавання	    noun:n:v_naz 
за	            prep:rv_rod:rv_zna:rv_oru
елітні	        adj:p:v_zna 
напої	        noun:p:v_zna 
звична	        adj:f:v_naz:compb 
річ	             noun:f:v_naz 
Раджу	         verb:pres:s:1:imperf 
власникам	     noun:p:v_dav:anim 
зайнятись	     verb:rev:inf:perf 
цим	            adj:m:v_oru:&pron:dem
якщо	        conj:subord 
вони	        pron:pers:p:3:v_naz:anim
не	            part 
поховати	   verb:inf:perf 
вкладені	    adjp:pasv:past:p:v_zna:v-u 
гроші	        noun:p:v_zna
Бо	            conj:subord
всі	            adj:p:v_naz:&pron:dem 
знають	        verb:pres:p:3:imperf 
приклади	  noun:p:v_zna
колись	      adv:&pron:ind 
модних	      adj:p:v_rod:compb
у	          prep:rv_zna:rv_mis:rv_rod:v-u 
Львові	      noun:m:v_mis 
закладів	   noun:p:v_rod 
які	           adj:p:v_zna:&pron:int:rel:def
через	        prep:rv_zna 
поведінку	    noun:f:v_zna 
персоналу	     noun:m:v_rod 
втратили	     verb:past:p:perf:v-u 
клієнтів	     noun:p:v_zna:anim 
і	             conj:coord
швидко	         adv:compb 
скотились	     verb:rev:past:p:perf 
у	             prep:rv_zna:rv_mis:rv_rod:v-u 
даруйте	         insert
понуре	        adj:n:v_zna 
лайно	        noun:n:v_zna 
Відродитися	    verb:rev:inf:perf 
мало	       adv:compb 
кому	       pron:int:rel:m:v_dav:anim
вдалося	       verb:rev:past:n:perf:v-u 
Заклад	       noun:m:v_naz  
для	           prep:rv_rod 
студентів	   noun:p:v_rod:anim 
Ресторан	   noun:m:v_naz
це	           adj:n:v_naz:&pron:dem
голосно	        adv:compb 
сказано	        verb:impers:perf 
Мафія	        noun:f:v_naz 
заклад	        noun:m:v_naz 
для	            prep:rv_rod 
невибагливих	 adj:p:v_rod 
студентів	    noun:p:v_rod:anim 
які	            adj:p:v_naz:&pron:int:rel:def
ще	            part 
не	            part 
заморочуються	 verb:rev:pres:p:3:imperf 
якістю	        noun:f:v_oru 
обслуговування	 noun:n:v_rod
От	             part 
для	             prep:rv_rod 
них	             pron:pers:p:3:v_rod:anim
там	             part 
все	            adv:v-u  
супер	        noun:m:v_naz 
і	            conj:coord
ідеально	     adv 
працює	         verb:pres:s:3:imperf 
цілодобово	      adv 
є	             verb:pres:s:3:imperf 
караоке	          noun:n:v_naz:nv:np 
можна	          predic 
взяти	          verb:inf:perf 
на	              prep:rv_zna:rv_mis 
компанію	     noun:f:v_zna 
метрову	         adj:f:v_zna 
піцу	         noun:f:v_zna 
й	             conj:coord 
отримати	     verb:inf:perf 
вино	         noun:n:v_naz 
в	             prep:rv_zna:rv_mis:rv_rod:v-u 
подарунок	     noun:m:v_zna 
що	             pron:int:rel:n:v_naz 
ще	             part 
треба	         predic 
для	             prep:rv_rod 
студентських	 adj:p:v_rod 
судячи	         advp:imperf 
з	             prep:rv_rod:rv_zna:rv_oru 
відгуків	     noun:p:v_rod 
про	             prep:rv_zna 
київську	     adj:f:v_zna 
мережу	         noun:f:v_zna 
в	             prep:rv_zna:rv_mis:rv_rod:v-u 
столиці	         noun:f:v_dav 
вони	         pron:pers:p:3:v_naz:anim 
й	             conj:coord
складають	     verb:pres:p:3:imperf 
основний	     adj:m:v_zna 
контингент	     noun:m:v_zna 
клієнтів         noun:p:v_rod:anim 
Мафій	         noun:p:v_rod 
А	             conj:coord 
дорослим	     noun:p:v_dav:anim 
тут	             adv:&pron:dem 
нема	         predic 
що	             pron:int:rel:n:v_zna 
робити	         verb:inf:imperf 
для	             prep:rv_rod 
них	             pron:pers:p:3:v_rod:anim 
у	             prep:rv_zna:rv_mis:rv_rod:v-u 
Львові	         noun:m:v_mis 
достатній	     adj:m:v_zna 
вибір	         noun:m:v_zna 
закладів	     noun:p:v_rod 
де	             part 
за	             prep:rv_rod:rv_zna:rv_oru 
ті	             adj:p:v_zna:&pron:dem 
самі	         adj:p:v_zna 
гроші	         noun:p:v_zna
можна	         predic 
отримати	     verb:inf:perf 
кращу	         adj:f:v_zna:compr 
їжу	             noun:f:v_zna 
і	             conj:coord 
належний	     adj:m:v_zna 
сервіс	         noun:m:v_zna 
Ресторан	     noun:m:v_naz
Мафія	         noun:f:v_naz 
Ми	              pron:pers:p:1:v_naz:anim
часто	         adv:compb 
відвідуємо	      verb:pres:p:1:imperf 
Мафію	          noun:f:v_zna 
і	              conj:coord 
завжди	          adv:&pron:gen 
все	              part:v-u
чисто	          adv:compb 
неперевершено	   adv 
смачно	          adv:compb 
І	              conj:coord  
обслуговування	   noun:n:v_naz
прекрасне	      adj:n:v_naz:compb 
КАТЕГОРИЧНО	      adv:compb 
НЕ	               part 
В	               prep:rv_zna:rv_mis:rv_rod:v-u 
РЕСТОРАН	      noun:m:v_zna 
МАФІЯ	          noun:f:v_naz 
Вчора	          adv:v-u 
вперше	           adv:v-u 
відвідала	       verb:past:f:perf 
з	               prep:rv_rod:rv_zna:rv_oru 
чоловіком	       noun:m:v_oru:anim 
ресторан	       noun:m:v_zna 
Мафія	           noun:f:v_naz 
у	               prep:rv_zna:rv_mis:rv_rod:v-u 
Львові	           noun:m:v_mis 
Враження	       noun:n:v_naz
Треба	           predic 
було	           verb:past:n:imperf 
залишити	       verb:inf:perf 
відгук	           noun:m:v_zna 
в	               prep:rv_zna:rv_mis:rv_rod:v-u 
книзі	           noun:f:v_mis 
скарг	           noun:p:v_rod 
та	              conj:coord
пропозиція	       noun:f:v_naz 
часу	          noun:m:v_rod 
стало	          verb:past:n:perf 
шкода	           noun:f:v_naz 
та	               conj:coord 
й	               conj:coord 
чоловік	           noun:m:v_naz:anim 
попросив	       verb:past:m:perf 
в	               prep:rv_zna:rv_mis:rv_rod:v-u 
такий	           adj:m:v_naz:&pron:def
день	           noun:m:v_naz
не	               part 
псувати	           verb:inf:imperf 
собі	           pron:refl:m:v_dav 
нерви	           noun:p:v_zna 
40	               number 
хвилин	           noun:p:v_rod 
чекали	           verb:past:p:imperf 
поки	           conj:subord 
до	               prep:rv_rod 
нас	               pron:pers:p:1:v_mis:anim
хтось	           pron:ind:v_naz:anim 
підійде	           verb:futr:s:3:perf 
за	               prep:rv_rod:rv_zna:rv_oru 
цей	               adj:m:v_zna:&pron:dem 
час	                noun:m:v_naz 
сусідній	         adj:m:v_zna 
пишно	           adv:compb 
неприбраний	      adj:m:v_zna 
стіл	           noun:m:v_zna 
який	           adj:m:v_naz:&pron:int:rel:def
ще	               part 
до	               prep:rv_rod 
нас	               pron:pers:p:1:v_rod:anim 
стояв	           verb:past:m:imperf 
неприбраним	       adj:m:v_oru 
так	               adv:&pron:dem
залишився	       verb:rev:past:m:perf 
і	               conj:coord 
після	           prep:rv_rod 
того	           adj:m:v_rod:&pron:dem 
як	               conj:subord 
ми	               pron:pers:p:1:v_naz:anim 
пішли	           verb:past:p:perf 
Абсолютно	       adv 
нікого	           pron:neg:v_rod:anim 
з	               prep:rv_rod:rv_zna:rv_oru
персоналу	       noun:m:v_rod 
не	               part 
хвилював	       verb:past:m:imperf 
обурювались	       verb:rev:past:p:imperf 
лише	           part 
відвідувачі	       noun:p:v_naz:anim 
що	               conj:subord  
нема	           predic 
де	               adv:&pron:int:rel 
сісти	           verb:inf:perf 
й	               conj:coord 
не	               part 
прибрано	       verb:impers:perf 
40	               number 
ХВИЛИН	          noun:p:v_rod 
Дівчина	          noun:f:v_naz:anim 
яка	              adj:f:v_naz:&pron:int:rel:def
носилась	      verb:rev:past:f:imperf 
взад-вперед	      adv 
невідомо	      adv 
чого	          pron:int:rel:n:v_rod 
бо	              conj:subord 
вона	          pron:pers:f:3:v_naz:anim 
нічого	          pron:neg:v_rod 
не	              part 
робила	           verb:past:f:imperf 
лише	           part 
бігала	          verb:past:f:imperf 
навіть	          part 
не	              part 
підходячи	      advp:imperf 
до	              prep:rv_rod 
клієнтів	      noun:p:v_rod:anim 
Коли	          conj:subord 
ми	              pron:pers:p:1:v_naz:anim
просили	          verb:past:p:imperf 
її	              pron:pers:f:3:v_rod:anim 
підійти	          verb:inf:perf 
вона	          pron:pers:f:3:v_naz:anim 
лише	          part 
обіцяла	          verb:past:f:imperf 
що	              conj:subord
до	              prep:rv_rod 
нас	              pron:pers:p:1:v_rod:anim 
хтось	          pron:ind:v_naz:anim 
підійде	          verb:futr:s:3:perf 
врешті	          adv:v-u 
ми	              pron:pers:p:1:v_naz:anim
самі	          adj:p:v_naz:&pron:def
знайшли	          verb:past:p:perf 
та	              conj:coord 
зловили	          verb:past:p:perf 
офіціанта	      noun:m:v_zna:anim 
за	              prep:rv_rod:rv_zna:rv_oru
руку	          noun:f:v_zna 
і	              conj:coord 
таки	          part 
примусили	      verb:past:p:perf 
взяти	          verb:inf:perf 
замовлення	      noun:n:v_zna
Коли	         conj:subord 			 
нам	             pron:pers:p:1:v_dav:anim
повідомили	     verb:past:p:perf 
що	             conj:subord  
на	             prep:rv_zna:rv_mis 
суші	         noun:p:v_zna 
треба	         predic 
чекати	         verb:inf:imperf 
40	             number 
хвилин	         noun:p:v_rod 
ми	             pron:pers:p:1:v_naz:anim
встали	         verb:past:p:perf:v-u 
й	             conj:coord
пішли	         verb:past:p:perf 
Поїли	         verb:past:p:perf 
за	             prep:rv_rod:rv_zna:rv_oru 
рогом	        noun:m:v_oru 
суші	         noun:p:v_zna 
які	             adj:p:v_zna:&pron:int:rel:def
зготували	     verb:past:p:perf 
за	              prep:rv_rod:rv_zna:rv_oru 
15	              number 
а	             conj:coord 
офіціанта	     noun:m:v_zna:anim 
чекали	         verb:past:p:imperf 
10	             number 
секунд	         noun:p:v_rod 
І	             conj:coord
ще	             part 
поруч	         prep:rv_rod 
сиділа	         verb:past:f:imperf 
пара	          noun:f:v_naz 
яка	              adj:f:v_naz:&pron:int:rel:def
теж	             part 
не	             part 
дочекавшись	     advp:rev:perf 
офіціанта	     noun:m:v_rod:anim
пішла	         verb:past:f:perf 
Хоч	             conj:subord 
ресторан	     noun:m:v_naz
був	             verb:past:m:imperf 
повний	         adj:m:v_naz:compb
за	             prep:rv_rod:rv_zna:rv_oru
40	             number 
очікування	     noun:n:v_naz
офіціанта	     noun:m:v_rod:anim
в	             prep:rv_zna:rv_mis:rv_rod:v-u 
зал	             noun:m:v_zna
винесли	         verb:past:p:perf 
лише	        part 
1	            number 
страву	        noun:f:v_zna 
А	             conj:coord
решта	         noun:f:v_naz 
відвідувачів	 noun:p:v_rod:anim
гаяли	         verb:past:p:imperf 
час	             noun:m:v_zna 
махаючи	         advp:imperf 
вашими	         adj:p:v_oru:&pron:pos 
величезними	     adj:p:v_oru 
МЕНЮ	         noun:n:v_oru:nv
Отже	        conj:subord 
можу	        verb:unknown 
залишити	    verb:inf:perf 
своє	        adj:n:v_zna:&pron:pos 
резюме	       noun:n:v_zna:nv
якщо	       conj:subord 
вам	           pron:pers:p:2:v_dav:anim 
дорогий	       adj:m:v_naz:compb 
ваш	           adj:m:v_naz:&pron:pos 
час	           noun:m:v_naz 
ви	           pron:pers:p:2:v_naz:anim 
ціните	       verb:pres:p:2:imperf 
гарне	       adj:n:v_zna:compb 
обслуговування	 noun:p:v_zna 
і	              conj:coord
теплу	        adj:f:v_zna:compb
атмосферу	    noun:f:v_zna 
ВАМ	             pron:pers:p:2:v_dav:anim 
КАТЕГОРИЧНО	     adv:compb 
НЕ	            part 
В	            prep:rv_zna:rv_mis:rv_rod:v-u 
РЕСТОРАН	    noun:m:v_zna 
МАФІЯ	        noun:f:v_naz 
Шановні	        adj:p:v_naz 
власники	    noun:p:v_kly:anim 
директора	     noun:m:v_rod:anim (noun:pl_kly)
і	            conj:coord
менеджери	    noun:p:v_kly:anim 
Соромно	        adv 
панове	       noun:p:v_kly:anim 
Ресторан	   noun:m:v_naz 
такого	       adj:m:v_rod:&pron:def 
рівня	       noun:m:v_rod 
а	           conj:coord 
обслуговування	  noun:n:v_naz
гірше	        adj:n:v_naz:compr 
ніж	            conj:subord 
в	            prep:rv_zna:rv_mis:rv_rod:v-u 
дешевій	        adj:f:v_mis:compb 
забігайлівці    noun:f:v_mis 
Кухню	        noun:f:v_zna 
оцінити	        verb:inf:perf 
не	            part 
можу	        verb:unknown 
бо	             conj:subord
не	             part 
спробувала	   verb:past:f:perf 
там	           adv:&pron:dem 
їсти	       verb:inf:imperf 
Сервіс	       noun:m:v_naz 
НУЛЬОВИЙ	  adj:m:v_naz  
Вечеряли	  verb:past:p:imperf 
в	           prep:rv_zna:rv_mis:rv_rod:v-u 
мафії	       noun:f:v_mis 
не	           part 
сподобалось	 verb:rev:past:n:perf 
одразу	     adv 
що	         conj:subord 
прибори	     noun:p:v_naz 
заплямовані	 adjp:pasv:past:p:v_naz 
а	         conj:coord 
як	         conj:subord 
потім	     adv:&pron:dem 
виявилось	 verb:rev:past:n:perf 
що	         conj:subord 
нам	         pron:pers:p:1:v_dav:anim 
принесли	 verb:past:p:perf 
ще	         part 
брудніші	 adj:p:v_zna:compr 
прибори	     noun:p:v_zna 
ніж	         conj:subord  
були	     verb:past:p:imperf 
Адміністратор	 noun:m:v_naz:anim 
це	           adj:n:v_naz:&pron:dem 
окрема	       adj:f:v_naz 
тема	     noun:f:v_naz 
сперечалась	 verb:rev:past:f:imperf 
з	         prep:rv_rod:rv_zna:rv_oru 
нами	     pron:pers:p:1:v_oru:anim 
що	         conj:subord 
все	          adv:v-u 
гаразд	      noun:m:v_naz 
не	           part 
вибачившись	  advp:rev:perf 
навіть	      part
просто	      adv:compb 
розвернулась	 verb:rev:past:f:perf 
і	           conj:coord 
пішла	       verb:past:f:perf 
розмовляти	   verb:inf:imperf 
з	           prep:rv_rod:rv_zna:rv_oru 
офіціанткою	   noun:f:v_oru:anim 
яка	           adj:f:v_naz:&pron:int:rel:def
нас	           pron:pers:p:1:v_zna:anim 
обслуговувала  verb:past:f:imperf 
Страви	       noun:p:v_naz 
відверто	   adv:compb 
несмачні	   adj:p:v_naz 
Шкода	       noun:f:v_naz 
що	           conj:subord 
такий	       adj:m:v_naz:&pron:def 
заклад	       noun:m:v_naz 
вбивають	   verb:pres:p:3:imperf:v-u 
некваліфіковані	 adj:p:v_naz 
працівники	   noun:p:v_kly:anim 
мені	       pron:pers:s:1:v_dav:anim 
у	           prep:rv_zna:rv_mis:rv_rod:v-u 
мафії	       noun:f:v_mis
подобається	   verb:rev:pres:s:3:imperf 
і	           conj:coord 
мені	       pron:pers:s:1:v_dav:anim 
у	           prep:rv_zna:rv_mis:rv_rod:v-u 
мафії	       noun:f:v_mis 
подобається	   verb:rev:pres:s:3:imperf 
і	           conj:coord 
попри	       prep:rv_zna
те	           adj:n:v_naz:&pron:dem 
що	           conj:subord 
там	           adv:&pron:dem 
завжди	       adv:&pron:gen 
купа	       noun:f:v_naz 
народу	       noun:m:v_rod 
там	           adv:&pron:dem 
смачно	       adv:compb 
класно	       adv 
і	           conj:coord 
більша	       adj:f:v_naz:compr 
частина	       noun:f:v_naz 
персоналу	   noun:m:v_rod 
надзвичайно	   adv 
привітні	    adj:p:v_zna:compb 
