Barabakh 20-30 female
Дійсно	дійсно adv  0
за	за      prep:rv_rod:rv_zna:rv_oru  0
кордом	корд    noun:m:v_oru  30
політика	політика noun:f:v_na -30
закладу	заклад  noun:m:v_rod 0
така	такий    adj:f:v_naz:&pron:def  0
що	що       conj:subord 		  0
харчування  харчування  noun:n:v_naz  25
у	у 		prep:rv_zna:rv_mis:rv_rod:v-u 0
ньому	він 		pron:pers:m:3:v_mis:an  0
доступне    доступний   adj:n:v_naz:compb  10
всім	весь 		adj:p:v_dav:&pron:dem  0
прошаркам  прошарок     noun:p:v_dav  0
населення  населення  	noun:n:v_rod  0
починаючи	починати   advp:imperf  0
від	від 	prep:rv_rod  0
школярів	школяр 	noun:p:v_rod:anim  20
та	та 	conj:coord  0
студентів	студент noun:p:v_rod:anim  20
туристів	турист  noun:p:v_rod:anim  45
та	та 	conj:coord  0
сімейних	сімейний  adj:p:v_rod 	 50
пар	 	пар	noun:p:v_rod 30
з	з 	prep:rv_rod:rv_zna:rv_oru  0
дітьми	діти    noun:p:v_oru:anim  40
незалежно	незалежно adv  10
від	від 	prep:rv_rod  0
рівня	рівень   noun:m:v_rod  0
доходу	доход   noun:m:v_rod  50
А	а 	conj:coord  0
ось	ось 	part  0
у	у	prep:rv_zna:rv_mis:rv_rod:v-u  0
нас	ми 	pron:pers:p:1:v_mis:anim  0
чомусь	чомусь  adv:&pron:ind  0
ситуація	ситуація noun:f:v_naz  0
абсолютно	абсолютно  adv  0
протилежна	протилежний adj:f:v_naz  -15
для	для 	prep:rv_rod  0
наших	наш 	adj:p:v_rod:&pron:pos  15
дітей	діти 	noun:p:v_rod:anim 40
та	та 	conj:coord  0
дорослих   дорослий    noun:p:v_rod:anim  10
похід	похід 	noun:m:v_naz  0
в	в 	prep:rv_zna:rv_mis:rv_rod:v-u  0
Макдональс	- 	-  -30
це	цей 	adj:n:v_naz:&pron:dem  0
дійсно	дійсно  adv  0
свято	свято   noun:n:v_naz  30
Витрати	витрата noun:p:v_naz  -10
на	на 	prep:rv_zna:rv_mis  0
смачну	смачний adj:f:v_zna:compb  30
але	але 	conj:coord  0
все	все	part:v-u 0
таки	таки 	part  0
не	не 	part  0
дуже	дуже    adv  10
корисну	корисний adj:f:v_zna:compb  20
їжу	їжа 	noun:f:v_zna  50
явно	явно 	adv  5
завищені	завищений adjp:pasv:past:p:v_naz  -10
Доброго	добрий  adj:m:v_rod:compb  15
дня	день    noun:m:v_rod  0
У	у 	prep:rv_zna:rv_mis:rv_rod:v-u  0
місті	місто 	noun:n:v_mis  0
Львові	Львів 	noun:m:v_mis  15
мав	мати 	verb:past:m:imperf  0
відбутись	відбутися verb:rev:inf:perf  0
хеппі	- 	-  40
парк	парк 	noun:m:v_naz   0
діти	діти 	noun:p:v_naz:anim  40
чекали	чекати 	verb:past:p:imperf  0
цього	цей     adj:m:v_zna:&pron:dem  0
свята	 свято   noun:p:v_zna 30
але	але 	conj:coord  0
на	на жаль <insert>  0
жаль	на жаль </insert>  -30
моя	мій 	adj:f:v_naz:&pron:pos  35
дитина	дитина 	noun:f:v_naz:anim  40
була	бути    verb:past:f:imperf  0
розчарована	розчарований adjp:pasv:past:f:v_naz  -40
оскільки	оскільки conj:subord  0
не	не      part  0
було	бути    verb:past:n:imperf  0
нічого	ніщо    pron:neg:v_rod -10
з	з 	prep:rv_rod:rv_zna:rv_oru  0
того	той 	adj:m:v_rod:&pron:dem  0
що	що 	pron:int:rel:n:v_naz  0
рекламували	рекламувати 	verb:past:p:perf  0
Було	бути 	verb:past:n:imperf  0
багато	багато 	numr:p:v_naz:&pron:ind  0
дітей	діти 	noun:p:v_naz:ani 40
які	який 	adj:p:v_naz:&pron:int:rel:def 0
очікували	очікувати verb:past:p:imperf 0
на	на 	prep:rv_zna:rv_mis  0
свято	свято 	noun:n:v_zna  30
і	і 	conj:coord  0
залишились	залишитися verb:rev:past:p:perf  0
розчарованими	розчарований adjp:pasv:past:p:v_oru  -30
не	не 	part  0
було	бути 	verb:past:n:imperf  0
організованості	організованість noun:f:v_rod  0
і	і 	conj:coord  0
жодних	жодний  adj:p:v_rod:&pron  -10
розваг	розвага noun:p:v_rod  10
для	для 	prep:rv_rod  0
дітей	діти 	noun:p:v_rod:anim  40
Прийміть	прийняти verb:impr:p:2:perf  0
це	цей 	adj:n:v_zna:&pron:dem 0
до	до 	prep:rv_rod  0
уваги	увага 	noun:f:v_rod  0
коли	коли 	adv:&pron:int:rel   0
буде	бути    verb:futr:s:3:imperf  0
організовувати	організовувати verb:inf:imperf  0
наступний	наступний       adj:m:v_zna  0
такий	такий 	adj:m:v_zna:&pron:def  0
захід	захід 	noun:m:v_zna  0
для	для 	prep:rv_rod  0
дітей	діти 	noun:p:v_rod:anim  40
я	я 	pron:pers:s:1:v_naz:anim 0
не	не 	part  0
знаю	знати   verb:pres:s:1:imperf  0
як	як 	conj:subord  0
вам	ви 	pron:pers:p:2:v_dav:anim 0
але	але 	conj:coord  0
мені	я 	pron:pers:s:1:v_dav:anim 0
там	там 	adv:&pron:dem  0
було	бути    verb:past:n:imperf  0
дуже	дуже 	adv 10
смачно	смачно  adv:compb  30
і	і       conj:coord  0
чисто	чисто   adv:compb  30
чому	чому    adv:&pron:int:rel 0
вам	ви 	pron:pers:p:2:v_dav:anim 0
не	не 	part  0
подобається	подобатися  verb:rev:pres:s:3:imperf  30
обслуговування	обслуговування  noun:n:v_naz  10
супер	супер 	noun:m:v_naz  50
і	і 	conj:coord  0
попри	попри   prep:rv_zna  0
велику	великий adj:f:v_zna:compb  0
чергу	черга   noun:f:v_zna  0
нам	ми 	pron:pers:p:1:v_dav:anim 0
було	бути 	verb:past:n:imperf  0
де	де 	adv:&pron:int:rel  0
сісти	сісти 	verb:inf:perf  0
також	також 	conj:coord  0
демократичні	демократичний 	adj:p:v_naz:compb  10
ціни	ціна   	noun:p:v_naz  0
що	що 	conj:subord  0
є	бути 	verb:pres:s::imperf  0
дуже	дуже 	adv 0
зручно	зручно 	adv:compb  20
для	для 	prep:rv_rod  0
середньо-статистичного	середньо-статистичний 	adj:m:v_rod  0
українця	українець 	 noun:m:v_rod:anim 10
ДЯКУЮ	дякувати verb:pres:s:1:imperf  0
ВАМ	ви 	 pron:pers:p:2:v_dav:anim 0
МАКДОНАЛЬДС	- 	-  -30
Дуже	дуже 	adv  0
шкода	шкода 	noun:f:v_naz  -40
що	що 	conj:subord  0
проблемою	проблема 	noun:f:v_oru  -30
стало	стати   verb:past:n:perf  0
забронювати	забронювати verb:inf:perf  0
на	на 	prep:rv_zna:rv_mis  0
1	1 	number  0
годину	година 	noun:f:v_zna  0
2	2	number  0
столики	столик 	noun:p:v_zna  0
для	для 	prep:rv_rod  0
дітей	діти 	noun:p:v_rod:anim  40
Це	цей 	adj:n:v_naz:&pron:dem 0
просто	просто 	adv:compb  0
позор	- 	-  -40
Замість	замість prep:rv_rod  0
того	той 	adj:n:v_rod:&pron:dem  0
щоб	щоб 	conj:subord  0
піти	піти    verb:inf:perf  0
клієнтам	клієнт noun:p:v_dav:anim  0
на	на 	prep:rv_zna:rv_mis  0
зустріч	зустріч noun:f:v_naz  45
ви	ви 	pron:pers:p:2:v_naz:anim 0
повернулись	повернутися verb:rev:past:p:perf  0
до	до 	prep:rv_rod  0
них	вони 	pron:pers:p:3:v_rod:anim 0
одним	один 	numr:n:v_oru  0
місцем	місце 	noun:n:v_oru  0
Це	цей 	adj:n:v_naz:&pron:dem  0
стосується	стосуватися 	verb:rev:pres:s:3:imperf  0
макдональдса	- 	-  -30
на	на  	prep:rv_zna:rv_mis  0
Володимира	Володимир 	noun:m:v_zna:anim:fname 0
Великого	великий 	adj:m:v_zna:compb  0
Лобрий	- 	-  0
день	день 	noun:m:v_naz  0
я	я 	pron:pers:s:1:v_naz:anim  0
тоже	- 	-  0
поїхала	поїхати verb:past:f:perf  0
з	з 	prep:rv_rod:rv_zna:rv_oru 0
2	2 	number  0
малими	малий 	adj:p:v_oru:compb  0
дітьми	діти 	noun:p:v_oru:anim  40
старша	старий 	adj:f:v_naz:compr  0
хотіла	хотіти 	verb:unknown  30
дуже	дуже    adv  0
чекала	чекати 	verb:past:f:imperf  0
але	але 	conj:coord  0
коли	коли    adv:&pron:int:rel 0
приїхала	приїхати verb:past:f:perf  0
розчарувалась	розчаруватися verb:rev:past:f:per -40
казала	казати 	verb:past:f:imperf  0
більше	багато  adv:compr 0
не	не 	part  0
піде	піти 	verb:futr:s:3:perf  0
на	на 	prep:rv_zna:rv_mis  0
таке	такий 	adj:n:v_zna:&pron:def  0
як	як 	conj:subord  0
для	для 	prep:rv_rod  0
для	для 	prep:rv_rod  0
менетаку	- 	-  0
рекламу	реклама noun:f:v_zna  0
зробили	зробити verb:past:p:perf  0
а	а 	conj:coord  0
толку	толк 	noun:m:v_rod  0
ніякого	ніякий 	adj:m:v_rod:&pron:neg  -10
нічо	- 	-  -10
там	там 	adv:&pron:dem   0
не	не	part  0
було	бути 	verb:past:n:imperf  0
крейда	крейда 	noun:f:v_naz  0
і	і 	conj:coord  0
кубики	кубик 	noun:p:v_naz 0
і	і 	conj:coord  0
все	все     adv:v-u  0
короче	- 	-  0
фігня	фігня 	noun:f:v_naz  -20
якась	якийсь  аdj:f:v_naz:&pron:ind  0
слова	слово 	noun:p:v_naz  0
швидка	швидкий adj:f:v_naz:compb  0
їжа	їжа 	noun:f:v_naz  50
звичайно	звичайно adv:compb  0
говорять	говорити verb:pres:p:3:imperf  0
самі	сам 	adj:p:v_naz:&pron:def 0
за	за 	prep:rv_rod:rv_zna:rv_oru 0
себе	себе 	pron:refl:m:v_zna  0
і	і 	conj:coord  0
кожен	кожний 	adj:m:v_naz:contr  0
сам	сам 	adj:m:v_naz:&pron:def  -40
для	для	prep:rv_rod  0
себе	себе 	pron:refl:m:v_rod  0
вирішує	вирішувати verb:pres:s:3:imperf  0
купувати	купувати verb:inf:imperf  0
чи	чи 	conj:coord:subord  0
готувати	готувати verb:inf:imperf  0
самому	сам 	adj:m:v_dav:&pron:def  0
Проте	проте  insert 0
коли	коли    conj:subord  0
вже	вже 	adv:v-u  0
є	бути 	verb:pres:p::imperf  0
такі	такий   adj:p:v_naz:&pron:def  0
заклади	заклад  noun:p:v_naz 0
котрі	котрий  adj:p:v_naz:&pron:int  0
беруть	брати   verb:pres:p:3:imperf  0
на	на 	prep:rv_zna:rv_mis  0
себе	себе 	pron:refl:m:v_zna  0
відповідальність	відповідальність  noun:f:v_zna  0
ШВИДКО	швидко  adv:compb  0
і	і	conj:coord  0
ЯКІСНО	якісно  adv:compb  40
нагодувати	нагодувати verb:inf:perf  10
людину	людина  noun:f:v_zna:anim  0
то	то      conj:subord  0
було	бути    verb:past:n:imperf  0
б	б	part  0
чудово	чудово  adv:compb  40
якби	якби    conj:subord  0
вони	вони    pron:pers:p:3:v_naz:anim 0
відповідали	відповідати verb:past:p:imperf  0
за	за 	prep:rv_rod:rv_zna:rv_oru 0
це	цей 	adj:n:v_zna:&pron:dem  0
на	на 	prep:rv_zna:rv_mis  0
всі	весь 	adj:p:v_zna:&pron:dem  0
100%	100% 	number  50
Сьогодні	сьогодні adv  0
були	бути 	verb:past:p:imperf  0
на	на 	prep:rv_zna:rv_mis  0
мало	мало 	adv:compb  -10
того	той 	adj:m:v_rod:&pron:dem 0
що	що	conj:subord  0
не	не	part  0
додали	додати 	verb:past:p:perf  0
замовлення	замовлення      noun:n:v_zna  0
та	та 	conj:subord  0
ще	ще 	part  0
й	й 	conj:subord  0
не	не 	part  0
дозапакували	- 	-  0
рол	- 	-  40
Почала	почати 	verb:past:f:perf  0
розпаковувати	розпаковувати 	verb:inf:imperf  0
в	в 	prep:rv_zna:rv_mis:rv_rod:v-u  0
машині	машина 	noun:f:v_mis  35
і	і 	conj:coord  0
добре	добре   adv 22
шо	- 	-  0
ледве	ледве 	adv  0
довезла	довезти verb:past:f:perf  0
до	до 	prep:rv_rod  0
дому	дім 	noun:m:v_rod  35
Вдома	вдома 	adv:v-u  30
довелося	довестися verb:rev:past:n:perf  0
просто	просто 	adv:compb  0
висипати	висипати verb:inf:imperf  0
його	він 	pron:pers:m:3:v_zna:anim 0
на	на 	prep:rv_zna:rv_mis  0
тарілку	тарілка noun:f:v_zna  0
замовлення	замовлення noun:n:v_naz  0
відбувалося	відбуватися verb:rev:past:n:imperf  0
ввечер	- 	-  0
Мабуть	мабуть 	insert  0
найпопулярніший	популярний adj:m:v_naz:super    50
заклад	заклад 	noun:m:v_naz  0
у	у 	prep:rv_zna:rv_mis:rv_rod:v-u  0
Львові	Львів 	noun:m:v_mis  15
Не	не 	part  0
знаю	знати   verb:pres:s:1:imperf  0
чому	чому    adv:&pron:int:rel  0
але	але 	conj:coord  0
все	весь 	adj:n:v_naz:&pron:dem 0
видається	видаватися verb:rev:pres:s:3:imperf 0
дуже	дуже    adv 10
смачним	смачний adj:n:v_oru:compb  40
ням-ням	- 	SENT_END  40
Макдак	- 	- -30
це	цей 	adj:n:v_naz:&pron:dem  0
лише	лише 	part  0
кафе	кафе	noun:n:v_naz:nv  0
при	при     prep:rv_mis 0
чому	чому    adv:&pron:int:rel  0
стандарти	стандарт noun:p:v_naz  0
якості	якість  noun:f:v_rod  30
там	там 	adv:&pron:dem  0
явно	явно 	adv  0
вищі	високий adj:p:v_naz:compr  10
ніж	ніж 	conj:subord  0
у	у 	prep:rv_zna:rv_mis:rv_rod:v-u  0
більшості	більшість    noun:f:v_rod  0
забігайлівок	забігайлівка noun:p:v_rod  -10
кафешок	кафешка noun:p:v_rod:slang  20
і	і 	conj:coord  0
подібних	подібний adj:p:v_rod  0
закладів	заклад 	 noun:p:v_rod 0
які	який 	adj:p:v_naz:&pron:int:rel:def 0
копіюють	копіювати verb:pres:p:3:imperf  0
той	той 	adj:m:v_naz:&pron:dem  0
макдональдс	- 	- -30
бургер	- 	-  -10
кінг	- 	-  0
кфс	- 	-  10
чи	чи	 conj:coord:subord 	 0
їм	вони  	 pron:pers:p:3:v_dav:anim  0
подібні	подібний adj:p:v_naz  0
Шкідливо	шкідливо adv:compb  -40
жерти	жерти 	verb:inf:imperf  -40
без	без 	prep:rv_rod  0
міри	міра 	noun:f:v_rod  0
а	а 	conj:coord 0
саме	самий 	adj:n:v_naz  0
кафе	кафе 	noun:n:v_naz:nv  0
нашкодити	нашкодити verb:inf:perf  -30
не	не 	part  0
може	могти 	verb:unknown  0
Їжа	їжа 	noun:f:v_naz  50
в	в 	prep:rv_zna:rv_mis:rv_rod:v-u  0
ньому	воно 	pron:pers:n:3:v_mis   0
продається	продаватися verb:rev:pres:s:3:imperf  0
різноманітна	різноманітний  adj:f:v_naz:compb  0
там	там 	adv:&pron:dem  0
крім	крім 	prep:rv_rod  0
всім	весь 	adj:p:v_dav:&pron:dem  0
відомих	відомий adj:p:v_rod:compb  20
бургерів	- 	-  0
і	і 	conj:coord  0
картоплі	картопля noun:f:v_rod  0
фрі	- 	-  0
і	і 	conj:coord  0
йогурти	йогурт 	noun:p:v_zna  0
є	бути 	verb:pres:p::imperf  0
і	і 	conj:coord  0
салатики	- 	-  0
і	і 	conj:coord  0
для	для 	prep:rv_rod  0
вегетаріанців	вегетаріанець 	noun:p:v_rod:anim  0
всілякі	всілякий 	adj:p:v_naz:&pron:gen:v-u 	 0
пропозиції	пропозиція  noun:p:v_naz  0
Тому	тому 	conj:subord  0
казати	казати 	verb:inf:imperf  0
що	що 	conj:subord  0
макдональдс	- 	-  -30
шкідливий	шкідливий adj:m:v_naz:compb  -40
це	цей 	adj:n:v_naz:&pron:dem  0
як	як 	adv:&pron:int:rel  0
казати	казати verb:inf:imperf 0
що	що 	conj:subord 0
будь-яке	будь-який 	adj:n:v_naz:&pron:ind  0
кафе	кафе 	noun:n:v_naz:nv  15
шкідливе	шкідливий adj:n:v_naz:compb  -40
в	в 	prep:rv_zna:rv_mis:rv_rod:v-u  0
місті	місто 	noun:n:v_mis  0
Львові	Львів   noun:m:v_mis  15
з	з 	prep:rv_rod:rv_zna:rv_oru  0
макдональдсу	- 	-  -30
біля	біля 	adv  0
оперного	оперний adj:m:v_mis 0
театру	театр 	noun:m:v_mis 0
менеджерка	-	-  0
виганяла	виганяти verb:past:f:imperf  -10
людей	люди 	noun:p:v_zna:anim  0
які	який 	adj:p:v_zna:&pron:int:rel:def 0
сиділи	сидіти 	verb:past:p:imperf  0
в	в 	prep:rv_zna:rv_mis:rv_rod:v-u  0
макдональдсі	- 	-  -30
більше	багато 	adv:compr 	 0
15	15 	number  0
хв	- 	-  0
ніколи	ніколи 	adv:&pron:neg  0
більше	багато  adv:compr  0
непіду	- 	-  -10
в	в 	prep:rv_zna:rv_mis:rv_rod:v-u  0
макдональдс	- 	-  -30
біля	біля 	adv  0
оперного	оперний 	adj:m:v_rod  0
театру	театр 	noun:m:v_rod  0
друзіям	- 	-  50
і	і 	conj:coord  0
знайомим	знайомий	adj:p:v_dav  45
пораджу	порадити verb:futr:s:1:perf  0
піти	піти	verb:inf:perf 0
в	в 	prep:rv_zna:rv_mis:rv_rod:v-u  0
інше	інший 	adj:n:v_zna:&pron:def  0
місці	місце 	noun:n:v_mis  0
а	а 	conj:coord  0
ніж	ніж 	conj:subord  0
в	в 	prep:rv_zna:rv_mis:rv_rod:v-u  0
макдональдс	- 	-  -30
Вчора	вчора 	adv:v-u  0
була	бути 	verb:past:f:imperf  0
в	в 	prep:rv_zna:rv_mis:rv_rod:v-u  0
мак-дональдсі	- 	-  -30
обжерлася	обжертися 	verb:rev:past:f:perf  -40
На	на щастя <insert>  0
щастя	на щастя </insert>  50
більше	багато 	adv:compr  0
1-2	1-2 	number  0
разів	раз 	noun:p:v_rod  0
на	на 	prep:rv_zna:rv_mis  0
місяць	місяць 	noun:m:v_zna  0
такі	такий 	adj:p:v_zna:&pron:def  0
місця	місце 	noun:p:v_zna  0
не	не 	part  0
відвідую	відвідувати 	verb:pres:s:1:imperf  0
Знайома	знайома noun:f:v_naz:anim  45
через	через 	prep:rv_zna  0
день	день 	noun:m:v_zna  0
ходить	ходити 	verb:pres:s:3:imperf  0
а	а 	conj:coord  0
потім	потім 	adv:&pron:dem  0
жаліється	жалітися 	verb:rev:pres:s:3:imperf -30
що	що 	conj:subord  0
поправилася	поправитися verb:rev:past:f:perf  -20
як	як 	conj:subord  0
від	від 	prep:rv_rod  0
такої	такий 	adj:f:v_rod:&pron:def  0
їжі	їжа 	noun:f:v_rod  50
можна	можна 	predic  0
не	не 	part  0
поправитися	поправитися 	verb:rev:inf:perf  -20
дивна	дивний 	adj:f:v_naz:compb  0
сьогодні	сьогодні 	adv  0
відвідала	відвідати 	verb:past:f:perf  0
Макдональдс	- 	-  -30
на	на 	prep:rv_zna:rv_mis  0
пл	- 	-  0
Свободи	свобода noun:f:v_rod  0
про	про 	prep:rv_zna  0
чистоту	чистота noun:f:v_zna  20
взагалі	взагалі adv:v-u  0
не	не 	part  0
йдеться	йтися 	verb:rev:pres:s:3:imperf  0
дівчина	дівчина noun:f:v_naz:anim  0
у	у 	prep:rv_zna:rv_mis:rv_rod:v-u  0
вишиванці	вишиванка noun:f:v_dav  30
спритно	спритно adv:compb  10
підпихала	- 	-  0
сміття	сміття  noun:n:v_zna  -30
з	з 	prep:rv_rod:rv_zna:rv_oru  0
підлоги	підлога noun:f:v_rod  0
у	у 	prep:rv_zna:rv_mis:rv_rod:v-u  0
переповний	- 	-  0
сміттєвий	сміттєвий adj:m:v_zna  -20
ящик	ящик 	noun:m:v_zna  0
в	в 	prep:rv_zna:rv_mis:rv_rod:v-u  0
кімнату	кімната noun:f:v_zna  0
зручностей	зручність 	noun:p:v_rod  0
потрапити	потрапити 	verb:inf:perf  0
було	бути 	verb:past:n:imperf  0
нереально	нереально adv  -10
не	не 	part  0
лише	лише 	part  0
через	через 	prep:rv_zna  0
величезну	величезний adj:f:v_zna  0
чергу	черга 	noun:f:v_zna  0
але	але 	conj:coord  0
й	й 	part  0
через	через 	prep:rv_zna  0
неймовірний	неймовірний adj:m:v_zna:compb  10
сморід	сморід 	noun:m:v_zna  -40
з	з 	prep:rv_rod:rv_zna:rv_oru  0
кабінки	кабінка noun:p:v_zna  0
враження	noun:p:v_zna  0
ніби	ніби 	part  0
через	через 	prep:rv_zna  0
неї	вона 	pron:pers:f:3:v_zna:anim  0
пройшла	пройти 	verb:past:f:perf  0
сотня	сотня 	noun:f:v_naz  0
людей	люди	noun:p:v_rod:anim  0
про	про 	prep:rv_zna  0
який	який 	adj:m:v_zna:&pron:int:rel:def 0
ресторан	ресторан noun:m:v_zna  0
ви	ви 	pron:pers:p:2:v_naz:anim  0
говорите	говорити verb:pres:p:2:imperf  0
просто	просто  part  0
вражаюче-таке	вражаюче-такий	adj:n:v_naz:&pron:def  50
чудо	чудо 	noun:n:v_naz  40
на	на 	prep:rv_zna:rv_mis  0
ценральній	- 	-  0
вулиці	вулиця  noun:f:v_mis  0
Львова	Львів 	noun:m:v_rod  15
ганьба	ганьба 	noun:f:v_naz  -45
сподіваюсь	сподіватися 	verb:rev:pres:s:1:imperf  0
що	що 	conj:subord  0
більше	багато  adv:compr 0
туди	туди 	adv:&pron:dem  0
не	не 	part  0
потраплю	потрапити  verb:futr:s:1:perf  0
Зайшов	зайти 	verb:past:m:perf  0
темі	тема 	noun:f:v_mis  0
і	і 	conj:coord  0
одразу	одразу 	adv  10
подивився	подивитися verb:rev:past:m:perf  0
фото	фото 	noun:n:v_zna:nv  20
і	і 	conj:coord  0
якщо	якщо 	conj:subord  0
чесно	чесно 	adv:compb  50
не	не 	part  10
зрозумів	зрозуміти verb:past:m:perf  0
що	що 	conj:subord  0
собою	себе 	pron:refl:m:v_oru  0
представляють	представляти verb:pres:p:3:imperf  0
ті	той 	adj:p:v_zna:&pron:dem 0
три	три 	numr:p:v_zna 0
купки	купка 	noun:p:v_zna  -20
на	на 	prep:rv_zna:rv_mis  0
таці	таця 	noun:f:v_mis  0
а	а 	conj:coord  0
вже	вже 	adv:v-u  0
потім	потім 	adv:&pron:dem  0
прочитавши	прочитати 	advp:perf  0
ваше	ваш 	adj:n:v_zna:&pron:pos  0
повідомлення	повідомлення   noun:n:v_zna  0
зрозумів	зрозуміти 	verb:past:m:perf  0
що	що 	conj:subord  0
то	то 	conj:subord  0
рис	рис 	noun:m:v_naz  15
яйце	яйце 	noun:n:v_naz  15
і	і 	conj:coord  0
курка	курка 	noun:f:v_naz:anim  15
Ви	ви 	pron:pers:p:2:v_naz:anim  0
знаєте	знати 	verb:pres:p:2:imperf  0
що	що 	conj:subord  0
в	в 	prep:rv_zna:rv_mis:rv_rod:v-u  0
McDonalds	- 	-  -30
серед	серед 	prep:rv_rod 0
співробітників	співробітник noun:p:v_rod:anim  10
існує	існувати verb:pres:s:3:imperf  0
правило	правило noun:n:v_naz  0
якщо	якщо 	conj:subord  0
гамбургер	гамбургер noun:m:v_naz -10
чи	чи 	conj:coord:subord  0
картопля	картопля noun:f:v_naz  15
лежать	лежати 	verb:pres:p:3:imperf  0
10	10 	number  0
хв	- 	-  0
то	то 	conj:subord  0
вони	вони 	pron:pers:p:3:v_naz:anim  0
підлягають	підлягати 	verb:pres:p:3:imperf  0
знищенню	знищення 	noun:n:v_dav  -30
і	і 	conj:coord  0
взагалі	взагалі adv:v-u  0
їжа	їжа 	noun:f:v_naz  50
цього	цей 	adj:m:v_rod:&pron:dem  0
фаст-фуди	фаст-фуд noun:p:v_zna  -30
придатна	придатний 	adj:f:v_naz:compb  10
до	до 	prep:rv_rod  0
вживання	вживання noun:n:v_rod:v-u  0
лише	лише 	conj:subord  0
на	на 	prep:rv_zna:rv_mis  0
протязі	протяг 	noun:m:v_mis  0
10	10 	number  0
хв	- 	-  0
після	після 	prep:rv_rod  0
продажи	- 	-  0
Дивно	дивно 	adv:compb  0
чи	чи 	part  0
не	не 	part  0
так	так 	part  0
Мені	я 	pron:pers:s:1:v_dav:anim  0
чомусь	чомусь  adv:&pron:ind  0
здається	здаватися verb:rev:pres:s:3:imperf  0
що	що 	conj:subord  0
McDonalds	- 	-  -30
грішить	грішити 	verb:pres:s:3:imperf  -20
з	з 	prep:rv_rod:rv_zna:rv_oru  0
використанням	використання noun:n:v_oru  -45
трансгенних	трансгенний adj:p:v_rod  -10
продуктів	продукт 	noun:p:v_rod 0
вплив	вплив 	noun:m:v_naz  0
яких	який 	adj:p:v_rod:&pron:int:rel:def 0
на	на	prep:rv_zna:rv_mis  0
організм	організм 	noun:m:v_zna  0
людини	людина noun:f:v_rod:anim  0
ще	ще 	adv  0
остаточно	остаточно 	adv  0
не	не 	part  0
досліджено	дослідити 	verb:impers:perf  0
Незважаючи	незважаючи 	prep  0
на	на 	part  0
те	той 	adj:n:v_zna:&pron:dem 0
що	що 	conj:subord  0
McDonalds	- 	-  -30
це	цей 	adj:n:v_naz:&pron:dem 0
франчайзингова	- 	-  0
структура	структура noun:f:v_naz  0
не	не 	part  0
будемо	бути 	verb:futr:p:1:imperf  0
забувати	забувати verb:inf:imperf  0
про	про 	prep:rv_zna  0
те	той 	adj:n:v_zna:&pron:dem  0
що	що 	pron:int:rel:n:v_zna  0
стандарти	стандартnoun:p:v_zna  40
в	в 	prep:rv_zna:rv_mis:rv_rod:v-u  0
приготуванні	приготування noun:n:v_mis  0
їжі	їжа 	noun:f:v_rod  50
в	в 	prep:rv_zna:rv_mis:rv_rod:v-u  0
усіх	увесь 	adj:p:v_mis:&pron:dem  0
країнах	країна 	noun:p:v_mis  0
а	а 	conj:coord  0
також	також 	conj:coord  0
основна	основний 	adj:f:v_naz  0
рецепутра	- 	-  0
повинні	повинний 	adj:p:v_naz  0
бути	бути 	verb:inf:imperf  0
однакові	однаковий adj:p:v_naz  0
На	на 	prep:rv_zna:rv_mis  0
моє	мій 	adj:n:v_naz:&pron:pos  0
переконання	переконання 	noun:n:v_zna  0
їжа	їжа	noun:f:v_naz  50
McDonalds	- 	-  -30
це	цей 	adj:n:v_naz:&pron:dem  0
зло	зло 	noun:n:v_naz  -50

бо	бо 	conj:subord  1
вона	вона 	pron:pers:f:3:v_naz:anim 1
надзвичайно	надзвичайно 	adv  11
колорійна	- 	-  -19
насправді	насправді adv  0
якщо	якщо 	conj:subord  0
їжа	їжа 	noun:f:v_naz  50
з	з 	prep:rv_rod:rv_zna:rv_oru  0
МcD	- 	-  -30
не	не 	part  0
є	бути 	verb:pres:s::imperf  0
основною	основний adj:f:v_oru  0
та	та 	conj:coord  0
постійною	постійний adj:f:v_oru  0
то	то 	conj:subord  0
немає	немає 	predic  -10
в	в 	prep:rv_zna:rv_mis:rv_rod:v-u  0
ній	вона 	pron:pers:f:3:v_mis:anim  0
нічого	нічого	adv  -10
шкідливішого	шкідливий adj:m:v_rod:compr  -20
за	за 	prep:rv_rod:rv_zna:rv_oru  0
всілякі	всілякий 	adj:p:v_zna:&pron:gen:v-u  0
чіпси	чіпси 	noun:p:v_zna  10
курчата	курча 	noun:p:v_zna:anim  35
гриль	гриль 	noun:m:v_zna  -10
тощо	тощо 	part  0
хочете	хотіти 	verb:unknown  10
здорової	здоровий 	adj:f:v_rod:compb  40
їжі	їжа 	noun:f:v_rod  50
їжте	їсти 	verb:impr:p:2:imperf  40
овочі	овоч 	noun:p:v_zna  40
фрукти	фрукт 	noun:p:v_zna  50
і	і 	conj:coord  0
то	то 	conj:subord  0
не	не 	part  0
всі	весь 	adj:p:v_zna:&pron:dem  0
та	та 	conj:coord  0
відварне	відварний adj:n:v_zna  0
м'ясо	м'ясо	noun:n:v_zna  30
сама	сам 	adj:f:v_naz:&pron:def  -35
іноді	іноді 	adv:&pron:ind  0
полюбляю	полюбляти verb:pres:s:1:imperf  10
забігти	забігти verb:inf:perf  0
в	в prep:rv_zna:rv_mis:rv_rod:v-u  0
McD	- 	-  0
за	за 	prep:rv_rod:rv_zna:rv_oru  0
картоплею	картопля 	noun:f:v_oru  15
та	та 	conj:coord  0
морозивом	морозиво noun:n:v_oru  40
жодного	жодний 	adj:m:v_rod:&pron  -10
разу	раз 	noun:m:v_rod  0
не	не 	part  0
отруїлась	отруїтися verb:rev:past:f:perf  -30
думаю	думати verb:pres:s:1:imperf  0
це	цей 	adj:n:v_naz:&pron:dem 0
просто	просто 	adv:compb  0
індивідуальна	індивідуальний adj:f:v_naz  0
фізіологія	фізіологія 	noun:f:v_naz  0
Фастфуди	фастфуд 	noun:p:v_naz  -40
по	по 	prep:rv_mis:rv_zna  0
замовчуванню	замовчування    noun:n:v_dav  0
шкідливі	шкідливий 	adj:p:v_naz:compb  -30
але	але 	conj:coord  0
після	після 	prep:rv_rod  0
макдональдсу	- 	-  -30
в	в 	prep:rv_zna:rv_mis:rv_rod:v-u  0
США	США 	noun:p:v_mis:nv:ns  10
я	я 	pron:pers:s:1:v_naz:anim  0
все	все 	part:v-u 0
таки	таки 	part  0
зацінила	- 	-  10
наш	наш 	adj:m:v_zna:&pron:pos  10
Вітчизняний	вітчизняний 	adj:m:v_naz  10
кращий	хороший 	adj:m:v_naz:compr  20
усі	увесь 	adj:p:v_naz:&pron:dem  0
іноземці	іноземець	noun:p:v_naz:anim  0
першим	перший  adj:n:v_oru  10
ділом	діло 	noun:n:v_oru  0
ідуть	іти 	verb:pres:p:3:imperf  0
в	в 	prep:rv_zna:rv_mis:rv_rod:v-u  0
макдональдс	- 	-  -30
тому	тому	conj:subord  0
що	що 	conj:subord  0
це	цей 	adj:n:v_naz:&pron:dem  0
місце	місце 	noun:n:v_naz  0
в	в 	prep:rv_zna:rv_mis:rv_rod:v-u  0
усіх	увесь 	adj:p:v_mis:&pron:dem  0
країнах	країна 	noun:p:v_mis  0
світу	світ   	noun:m:v_rod 0
однакове	однаковий adj:n:v_naz  0
щодо	щодо 	prep:rv_rod  0
мене	я 	pron:pers:s:1:v_rod:anim  0
макдональдс	- 	-  -30
це	цей 	adj:n:v_naz:&pron:dem  0
вигідне	вигідний 	adj:n:v_naz:compb  10
містезнаходження	- 	-  0
для	для 	prep:rv_rod  0
зустрічі	зустріч noun:f:v_rod  10
я	я 	pron:pers:s:1:v_naz:anim  0
там	там 	adv:&pron:dem  0
часто	часто 	adv:compb  5
п'ю	пити 	verb:pres:s:1:imperf  40
чай	чай 	noun:m:v_zna  45
чи	чи 	conj:coord:subord  0
кофе	- 	-  30
їжа	їжа 	noun:f:v_naz  50
тільки	тільки 	part   0
дуже	дуже 	adv 10
рідко	рідко   adv:compb  -20
коли	коли 	conj:subord  0
як	як 	conj:subord  0
то	то 	conj:subord  0
кажеться	казатися verb:rev:pres:s:3:imperf 0
гавнєца	- 	-  -40
захотєлось	- 	-  -10
не	не 	part  0
тре	терти 	verb:pres:s:3:imperf  0
це	цей 	adj:n:v_zna:&pron:dem 0
робити	робити 	verb:inf:imperf  0
ні	ні 	part  -10
макдональдсам	- 	-  -30
в	в 	prep:rv_zna:rv_mis:rv_rod:v-u  0
макдональдсі	- 	-  -30
найбільше	багато 	adv:super 10
люблю	любити  verb:pres:s:1:imperf  50
каву	кава    noun:f:v_zna  30
і	і 	conj:coord  0
морозиво	морозиво noun:n:v_zna  30
морозиво	морозиво noun:n:v_naz  30
їм	їсти    verb:pres:s:1:imperf 35
не	не 	part  0
часто	часто   adv:compb  15
тому	тому 	conj:subord 0
шкоди	шкода 	noun:f:v_rod  -30
якоїсь	якийсь 	adj:f:v_rod:&pron:ind  0
не	не 	part  0
передбачаю	передбачати verb:pres:s:1:imperf  0
а	а 	conj:comrd  0
решта	решта 	noun:f:v_naz  0
їжа	їжа 	noun:f:v_naz  50
то	то 	conj:subord  0
намагаюсь	намагатися verb:rev:pres:s:1:imperf -10
уникати	уникати verb:inf:imperf  -35
так	так 	conj:coord:subord  0
як	як 	conj:subord  0
не	не 	part  0
довіряю	довіряти verb:pres:s:1:imperf  10
Нещодавно	нещодавно adv  0
моя	мій 	adj:f:v_naz:&pron:pos  35
знайома	знайома noun:f:v_naz:anim 20
отруїлася	отруїтися verb:rev:past:f:perf  -50
в	в 	prep:rv_zna:rv_mis:rv_rod:v-u  0
львівському	львівський adj:m:v_mis  15
макдональдсі	- 	-  -30
ІМХО	- 	-  0
про	про 	prep:rv_zna  0
корисність	корисність 	noun:f:v_zna  21
такої	такий 	adj:f:v_rod:&pron:def  21
їжі	їжа 	noun:f:v_rod  50
і	і 	conj:coord  21
так	так 	part  21
все	все 	adv:v-u  0
ясно	ясно 	adv:compb  10
якщо	якщо 	conj:subord  0
дійсно	дійсно	adv  0
рідко	рідко 	adv:compb  -15
то	то 	conj:subord  0
не	не 	part  0
шкідливий	шкідливий adj:m:v_naz:compb  -40
їда	їда 	noun:f:v_naz  50
в	в 	prep:rv_zna:rv_mis:rv_rod:v-u  0
нас	ми 	pron:pers:p:1:v_mis:anim  0
на	на 	prep:rv_zna:rv_mis  0
кухні	кухня 	noun:f:v_mis  25
не	не 	part  0
менш	мало 	adv:compr  -16
шкідлива	шкідливий adj:f:v_naz:compb  -40
Як	як 	conj:subord  0
був	бути 	verb:past:m:imperf  0
у	у 	prep:rv_zna:rv_mis:rv_rod:v-u  0
Львові	Львів 	noun:m:v_mis  15
то	то 	conj:subord  0
заходив	заходитиverb:past:m:imperf  0
Чомусь	чомусь  adv:&pron:ind  0
виникла	виникнути verb:unknown  0
асоціація	асоціація noun:f:v_naz  0
з	з 	prep:rv_rod:rv_zna:rv_oru 0
конвеєром	конвеєр noun:m:v_oru  -15
та	та 	conj:coord  0
телячою	телячий adj:f:v_oru  -10
фермою	ферма 	noun:f:v_oru 5
Таке	такий 	adj:n:v_naz:&pron:def  0
враження	враження noun:n:v_naz  35
що	що 	conj:subord  0
народ	народ 	noun:m:v_naz  0
туди	туди 	adv:&pron:dem  0
заходить	заходити verb:pres:s:3:imperf  0
тупо	тупо 	adv:compb  -20
щось	щось 	pron:ind:n:v_zna  0
вкинути	вкинути verb:inf:perf:v-u  0
в	в 	prep:rv_zna:rv_mis:rv_rod:v-u  0
шлунок	шлунок  noun:m:v_zna  0
і	і 	conj:coord  0
чимось	щось 	pron:ind:n:v_oru  0
це	цей 	adj:n:v_naz:&pron:dem  0
залити	залити 	verb:inf:perf  0
Я	я 	pron:pers:s:1:v_naz:anim 0
вже	вже 	adv:v-u  0
не	не 	part  0
говорю	говорити 	verb:pres:s:1:imperf  0
про	про 	prep:rv_zna  0
шкідливість	шкідливість noun:f:v_naz  -40
такого	такий  adj:n:v_rod:&pron:def  0
харчування	харчування noun:n:v_rod  15
От	от 	part  0
у	у 	prep:rv_zna:rv_mis:rv_rod:v-u  0
нас	ми 	pron:pers:p:1:v_mis:anim  0
зайти	зайти 	verb:inf:perf  0
хоча	хоча 	part  0
б	б 	part  0
у	у 	prep:rv_zna:rv_mis:rv_rod:v-u  -5
банальну	банальний adj:f:v_zna:compb  -10
столову	столовий adj:f:v_zna  0
то	то 	conj:subord  0
тут	тут 	adv:&pron:dem  0
тобі	ти 	pron:pers:s:2:v_dav:anim  0
і	і 	conj:coord  0
картопелька	картопелька noun:f:v_naz  15
варена	варений adj:f:v_naz:&adjp:pasv:past  20
і	і 	conj:coord  0
салат	салат   noun:m:v_naz  20
і	і 	conj:coord  0
борщик	борщик  noun:m:v_naz  40
і	і 	conj:coord  0
ще	ще 	part  0
купа	купа 	noun:f:v_naz  0
всякого	всякий 	adj:m:v_rod:&pron:gen:v-u  0
от	от 	part  0
там	там 	adv:&pron:dem  0
можна	можна 	predic  0
нормально	нормально adv  10
поїсти	поїсти 	verb:inf:perf  0
зі	зі 	prep:rv_rod:rv_zna:rv_oru 0
десь	десь 	adv:&pron:ind  0
я	я 	pron:pers:s:1:v_naz:anim  0
вже	вже 	adv:v-u  0
таку	такий 	adj:f:v_zna:&pron:def  0
тему	тема 	noun:f:v_zna  0
бачив	бачити 	verb:past:m:imperf  0
Теж	теж 	part  0
при	при 	prep:rv_mis 0
нагоді	нагода  noun:f:v_dav 0
люблю	любити 	verb:pres:s:1:imperf  50
Макдакову	- 	- -30
каву	кава 	noun:f:v_zna  30
особливо	особливо 	adv  0
з	з 	prep:rv_rod:rv_zna:rv_oru  0
ледом	- 	-  10
у	у prep:rv_zna:rv_mis:rv_rod:v-u  0
спеку	спека 	noun:f:v_zna  -10
Хоч	хоч 	part  0
розумію	розуміти 	verb:pres:s:1:imperf  0
що	що 	conj:subord  0
вона	вона 	pron:pers:f:3:v_naz:anim  0
добра	добрий  adj:f:v_naz:compb   30
чи	чи 	conj:coord:subord  0
смачна	смачний adj:f:v_naz:compb  50
за	за 	prep:rv_rod:rv_zna:rv_oru 0
рахунок	рахунок noun:m:v_zna  0
сильного	сильний adj:n:v_rod:compb  0
присмаження	- 	-  -10
там	там 	adv:&pron:dem  0
сорт	сорт 	noun:m:v_naz  0
кави	кава 	noun:f:v_rod  30
вже	вже 	adv:v-u  0
не	не 	part  0
має	мати 	verb:pres:s:3:imperf 0
значення	значення noun:n:v_rod  0
Але	але 	conj:coord  0
на	на 	prep:rv_zna:rv_mis  0
безриб'ї	безриб'я 	noun:n:v_mis  -20
вони	вони 	pron:pers:p:3:v_naz:anim 0
виграють	вигравати   verb:pres:p:3:imperf  0
проти	проти 	adv  0
інших	інший 	adj:p:v_rod:&pron:def  0
хіба	хіба 	part 0
що	що 	conj:subord  0
Старбаксу	- 	-  10
поступаються	поступатися verb:rev:pres:p:3:imperf  -10
за	за 	prep:rv_rod:rv_zna:rv_oru 0
каву	кава 	noun:f:v_zna 30
