Обслуговування 	 	noun:n:v_naz
жахливе      	     adj:n:v_zna:compb
Чекали 	           	verb:past:p:imperf
замовлення   	    noun:n:v_zna
півгодини     	 numr 
потім 	            	adv
нас 	            pron:pers:p:1:v_zna:anim
обрахували   	      verb:past:p:perf
на                      prep:rv_zna
грн 	                     noun:f:v_zna:nv:abbr    
не 	                          part
видавши 	     advp:perf
чеку 	         noun:m:v_zna                                 
Слідкуйте   	      verb:impr:p:2:imperf
за           	              prep:rv_oru
своїм        	            pron:pos
персоналом   	     	noun:m:v_oru
бо           	          	conj:subord                 
заслужена 	          adjp:pasv:past:f:v_naz
роками 	                     noun:p:v_oru
репутація    	       noun:f:v_naz
в           	           	prep:rv_zna:v-u
один        	          	numr:m:v_zna
момент         	      	noun:m:v_zna
розіб'ється 	   	verb:rev:futr:s:3:perf
вщент 	               	adv:v-u
Якщо 	                 	conj:subord
офіціант 	            noun:m:v_naz:anim
стажується  	 	verb:rev:pres:s:3:imperf
він 	                 	pron:pers:m:3:v_naz:anim
не             	          	part
має 	                    verb:pres:s:3:imperf                
права                      noun:p:v_zna
грубити 	           	verb:inf:imperf
відвідувачам 	   	noun:p:v_dav:anim
не 	                         	part	
видавати 	        	verb:inf:imperf
їх            	         	pron:pers:p:3:v_zna:anim
чек 	                  	noun:m:v_zna
та           	           	conj:coord                             
обраховувати 		verb:inf:imper	
міняйте 	              verb:impr:p:2:imperf
персонал 	         	noun:m:v_zna
Кафе 	              	    noun:n:v_naz:nv                             
непогане 	    	    adj:n:v_zna
Гарячий 	       	    adj:m:v_naz:compb                                
шоколад 	      	    noun:m:v_naz                                
там 	             	    adv                                
мені 	                	    pron:pers:s:1:v_dav:anim                                
сподобався 	    	    verb:rev:past:m:perf
а         	            	    conj:coord                                
каву 	                 	noun:f:v_zna
не       	                 	part
куштував 	    	    verb:past:m:imperf
бо 	                  	    conj:subord                                
вечір 	            	    noun:m:v_naz                                
був 	                    verb:past:m:imperf
я 	                           pron:pers:s:1:v_naz:anim
ввечері 	     	    adv:v-u
каву 	             	    noun:f:v_zna
не 	                          part
вживаю 	          	    verb:pres:s:1:imperf:v-u
На 	                       	prep:rv_mis
2-му 	             	    adj:m:v_mis                               
поверсі 	       	    noun:m:v_mis
кафе 	                	noun:n:v_rod:nv                               
розміщується    	verb:rev:pres:s:3:imperf
магазин 	          	noun:m:v_naz                                
шоколаду 	         	noun:m:v_rod
Я 	                          pron:pers:s:1:v_naz:anim
коли 	                    conj:subord                      
ціни 	                    noun:p:v_zna
побачив 	    	    verb:past:m:perf
то 	                       	conj:subord
в             	            	prep:rv_rod:v-u
мене 	               	    pron:pers:s:1:v_rod:anim
відпало      		    verb:past:n:perf
бажання      	  	    noun:n:v_naz                                
що-небудь 	        	pron:ind:n:v_zna
купувати 	        	verb:inf:imperf
там                      	adv				
бо 	                      	conj:subord                                
одна 	                	numr:f:v_naz
невеличка 	    	    adj:f:v_naz
цукерка 	       	    noun:f:v_naz
коштує   	    	    verb:pres:s:3:imperf
або 	             	    conj:coord
6        	            	    number
гривень 	       	    noun:p:v_rod
За 	                    	    prep:rv_zna
таку 	             	    adj:f:v_zna
ціну 	             	    noun:f:v_zna
воно 	              	    pron:pers:n:3:v_naz
мені 	                 	    pron:pers:s:1:v_dav:anim                                
нафіг 	                	adv:slang
не       	                  part
треба 	                	predic
хоч 	                  	conj:subord
би 	                          part
яким 	             	    pron:int:rel:def                                                    
воно 	                 	pron:pers:n:3:v_naz
не       	          	    part
було 	             	    verb:past:n:imperf
Придбав 	    	    verb:past:m:perf
на       	            prep:rv_zna
подарунок 	      	    noun:m:v_zna
тільки 	              	part
квадратик 	    	    noun:m:v_zna
плитки 	               	noun:f:v_rod                               
молочного 	        	adj:m:v_rod                               
шоколаду 	      	    noun:m:v_rod
з 	                    prep:rv_oru
цільними 	      	    adj:p:v_oru
горіхами 	        	    noun:p:v_oru                  	   
Вага 	                 	noun:f:v_naz
десь 	            	    adv
ціна 	                    noun:f:v_naz
грн 	              	    noun:f:v_naz:nv:abbr                         
Але 	                     conj:coord                                
туристи 	        	    noun:p:v_naz:anim
поряд 	                   prep:rv_oru 
мною 	                   	pron:pers:s:1:v_oru:anim
з 	                        	prep:rv_rod
сусіднього 	          	adj:m:v_rod                         					
ситого 	                 	adj:m:v_rod                                
Євросоюзу 	         	noun:m:v_rod					
набирали 	    	    verb:past:p:imperf
ці       	         	    pron:dem                               
всі 	                    pron:dem
шоколадні 	    	    adj:p:v_zna
ручні 	               	adj:p:v_zna
витвори 	           	noun:p:v_zna
кондитерського  	   adj:n:v_rod                                
мистецтва 	           noun:n:v_rod                                
цілими   	            	adj:p:v_oru
кошиками 	           	noun:p:v_oru
зарплатня 	    	    noun:f:v_naz
ж 	                    	    part				
мабуть   	       	    insert
не 	                       	part
така 	                 	pron:def
як 	                          conj:subord                                
у 	                        	prep:rv_rod:v-u
нас 	               	    pron:pers:p:1:v_rod:anim                                
на 	                       	prep:rv_mis
Україні 	         	noun:f:v_mis
Взагалі 	             adv:v-u
заклад 	           	    noun:m:v_naz                                
сподобався 	    	    verb:rev:past:m:perf
ще      	           	    part
й 	                    	    part
шоколадом 	      	    noun:m:v_oru	
пахне 	           verb:pres:s:3:imperf 
за                     	    prep:rv_oru
скляною 	       	    adj:f:v_oru
стіною 	            	    noun:f:v_oru
його 	                    pron:pos                            
роблять 	       	    verb:pres:p:3:imperf
і 	                   	    conj:coord               
ти 	                          pron:pers:s:2:v_naz:anim
можеш         	           verb:unknown
спостерігати        verb:inf:imperf	
це 	                  	    pron:dem                                
дійство 	         	noun:n:v_zna
Але 	              	    conj:coord
без 	               	    prep:rv_rod	
фанатизму 	    	    noun:m:v_rod 							   
всі 	             	    pron:dem                                
цукерки 	         	noun:p:v_zna
скуштувати 	    	    verb:inf:perf
за 	                      	prep:rv_zna
такі 	            	    pron:def                                
гроші 	                   noun:p:v_zna                
все	одно 	          adv           
не        	            	    part
вийде 	           verb:futr:s:3:perf
бо 	                   	    conj:subord                                
грошей 	            	    noun:p:v_rod
не 	                   	    part
вистачить 	    	    verb:futr:s:3:perf
Черги 	         	        noun:p:v_naz                               								
це       	       	        pron:dem
не        	        	        part
найстрашніше            adj:n:v_zna:super                				
На           	              prep:rv_mis
першому 	     	        adj:m:v_mis                                
поверсі 	    	        noun:m:v_mis
у 	                	        prep:rv_rod:v-u
кав'ярні 	           noun:f:v_rod                                
працюють 	    	    verb:pres:p:3:imperf
дуже 	                    adv     
приємні 	            adj:p:v_naz:compb                                
люди 	         	        noun:p:v_naz:anim								
але 	         	        conj:coord                             
у 	                           prep:rv_rod:v-u
крамниці 	    	    noun:f:v_rod                                								
люди 	        	         noun:p:v_naz:anim
дуже 	                    adv                
хамовиті 	            adj:p:v_zna
Зазвичай 	             adv
так 	              	    part
себе 	          	        pron:refl:m:v_zna                               
не            	              part
поводять 	    	    verb:pres:p:3:imperf
коли 	                    conj:subord                                             
зацікавлені         adjp:pasv:past:p:v_naz                                
щось 	                    pron:ind:n:v_zna
продати 	             verb:inf:perf
Адміністрація 	   noun:f:v_naz
мала 	                     verb:past:f:imperf
б 	                           part
звернуту 	            verb:past:f:imperf
увагу 	                   noun:f:v_zna
на   	                     	prep:rv_zna
ввічливість 	 	noun:f:v_zna:v-u
продавців 	         	noun:p:v_rod:anim	
Ми 	                          pron:pers:p:1:v_naz:anim
були 	                	verb:past:p:imperf
в 	                        	prep:rv_mis:v-u
серпні       	        	noun:m:v_mis                                
Одного 	                	numr:m:v_rod                                
разу 	                 	noun:m:v_rod
мала 	                    verb:past:f:imperf
можливість   		    noun:f:v_zna
тут 	                     adv
побувати 	            verb:inf:perf
дуже 	                    adv                
хотіла    	              verb:unknown
знати    	        	    verb:inf:imperf
що       	           	    conj:subord                                
ж 	                          	part
це 	                      	pron:dem                                
за 	                          prep:rv_zna
ресторан 	    	    noun:m:v_zna
Поплавського         noun:m:v_rod:anim:lname
Була 	                    verb:past:f:imperf
зимою 	             	    noun:f:v_oru
склалося 	    	    verb:rev:past:n:perf
приємне 	    	    adj:n:v_naz:compb                                
враження 	     	    noun:n:v_naz                                
про 	                 	prep:rv_zna
заклад   	           	noun:m:v_zna					
тепла     	              adj:f:v_naz:compb                
затишна 	    	    adj:f:v_naz:compb
атмосфера 	    	    noun:f:v_naz
Смакувала      		    verb:past:f:imperf
борщиком 	       	    noun:m:v_oru
та       	           	    conj:coord                              
телятиною 	    	    noun:f:v_oru
з         	             	    prep:rv_oru
овочами 	         	    noun:p:v_oru	
Страви 	           	    noun:p:v_naz                                
смачні   	      	    adj:p:v_zna:compb								
гарна    	              adj:f:v_naz:compb
а 	                     	    conj:coord                                
головне 	   adv
своєчасна 	    	    adj:f:v_naz
подача   	           	noun:f:v_naz
Єдиним  	       	    adj:m:v_oru                                
мінусом 	        	    noun:m:v_oru
є         	         	    verb:pres:p:3:imperf                                
високі 	         	    adj:p:v_naz:compb                                
ціни 	                    noun:f:v_naz						
особисто 	    	    adv:compb
для 	                     prep:rv_rod
мене 	                	    pron:pers:s:1:v_rod:anim
цей 	                  	pron:dem                                
заклад  	       	    noun:m:v_naz                                
не        	                  part
для 	                     prep:rv_rod
частого 	        	    adj:n:v_rod:compb
відвідування    	noun:n:v_rod  
ОГО 	                     excl
скільки 	          	numr:p:v_naz
різних 	        	        adj:p:v_rod                                
відгуків 	              noun:p:v_rod
Проблема 	    	    noun:f:v_naz
літнього 	    	        adj:m:v_rod                                
сезону       	    	    noun:m:v_rod
у              	          	    prep:rv_mis:v-u
Львівських 	     	    adj:p:v_mis                                
закладах 	       	    noun:p:v_mis
популярність 	    noun:f:v_naz                                						   
яка 	          conj:subord
львів'янам   		    noun:p:v_dav:anim
вже 	             	    adv:v-u
сильно       	   	    adv:compb
остогидла 	         verb:past:f:perf
і 	                        	conj:coord                                
дійсно 	               	adv
я 	                    	    pron:pers:s:1:v_naz:anim
своїх 	            	    pron:pos                                
гостей 	             	    noun:p:v_rod:anim                                
намагаюся    		    verb:rev:pres:s:1:imperf
просто 	           	    adv:compb                                
завести                  verb:inf:perf
показати        	    verb:inf:perf
таке 	             	    pron:def                                
наше 	               	    pron:pos                                
диво 	             	    noun:n:v_zna				
Майстерня 	           noun:f:v_naz
Шоколаду 	      	    noun:m:v_rod 								
яка 	          conj:subord
вражає 	           	    verb:pres:s:3:imperf
всіх 	             	    pron:dem                                
ласунів 	        	    noun:p:v_rod:anim 
По 	                       	prep:rv_mis:
смакоті 	         	noun:f:v_mis						
дійсно 	           	    adv
поки 	            	    conj:subord
що             	 part       
найбільший   	  	    adj:m:v_naz:super                                
вибір        	   	    noun:m:v_naz                                
і 	                     	    conj:coord                                
дуже         	            adv           
смачно 	            	    adv:compb
по           	       	    prep:rv_mis
цінах 	             	    noun:p:v_mis
власники 	      	    noun:p:v_naz:anim							
скоро 	            	    adv:compb
луснуть 	      	    verb:futr:p:3:perf
від 	               	    prep:rv_rod
жадності 	    	    noun:f:v_rod                                
Є 	                 	    verb:pres:p:3:imperf                                
кав'ярні 	    кав'ярня	    noun:p:v_naz                                							
де           	conj:subord           
можна       	    	    predic
набагато 	    	    adv
спокійніше   	       adj:n:v_naz:compr                                                
випити      	   	    verb:inf:perf
каву 	            	    noun:f:v_zna
з 	                    	    prep:rv_oru
авторськими 		    adj:p:v_oru
цукерками        	    noun:p:v_oru
біля 	             	    adv
Арсеналу 	      	    noun:m:v_rod							
на 	                  	    prep:rv_mis	
Краківській 		    adj:f:v_mis							
Вероніка 	            noun:f:v_naz:anim:fname 
Бо 	                  	     part
коли 	                    conj:subord                 
платиш 	          	    verb:pres:s:2:imperf
такі 	             	    pron:def                                
гроші 	                   noun:p:v_zna 			
хочеться 	    	    verb:unknown	
і 	                   	    conj:coord                                
солодкого    	 	    adj:n:v_zna:compb
забуття 	      	    noun:n:v_zna
Теж 	              part
два 	              	    numr:p:v_zna                                
роки 	              	    noun:p:v_zna
тому 	                    adv                              
не 	                          part
могла 	            	    verb:unknown
оминути 	       	    verb:inf:perf
цей 	              	    pron:dem                                
заклад 	           	    noun:m:v_zna					
але 	              	    conj:coord                               
зараз 	                   adv                
відчувається 		    verb:rev:pres:s:3:imperf
що 	                   	    conj:subord                                
запах 	                   noun:m:v_naz                                
купюр 	                  noun:p:v_rod
тут 	              	    adv
перебиває 	    	    verb:pres:s:3:imperf
аромат 	           	    noun:m:v_zna
шоколаду     	    	     noun:m:v_rod
Але 	                 	conj:coord                                
в 	                    	    prep:rv_mis:v-u
якості        	   	    noun:f:v_mis                                
туриста      	          noun:m:v_rod:anim                                
зайти        	   	    verb:inf:perf
варто 	            	    predic
Повертаючись 	       advp:rev:imperf
з 	                          prep:rv_rod
відпочинку 	          noun:m:v_rod
заїхали      	         verb:past:m:perf
пообідати    	       verb:inf:perf
з 	                           prep:rv_oru
дітьми 	                    noun:p:v_oru:anim
в 	                      	    prep:rv_zna:v-u
Батьківську 		adj:f:v_zna
хату 	                    noun:f:v_zna  
на           	      	    prep:rv_mis
трасі 	             	    noun:f:v_mis
Одеса-Київ 	     	    noun:f:v_naz
очікували 	           verb:past:p:imperf
кращого 	    adv:compr                             
Замовлення 	       	 noun:n:v_zna                                
чекали   	              verb:past:p:imperf
хвилин 	              	noun:p:v_rod
але 	                  	conj:coord                                
було 	                    verb:past:n:imperf
дуже 	                    adv                
багато  	              numr:p:v_rod
людей    	               	noun:p:v_rod:anim                                			
можна 	                 	predic
і 	                        	conj:coord
не 	                          part
звертати 	         	verb:inf:imperf
увагу 	                   noun:f:v_zna
Фірмовий 	         	adj:m:v_naz                                
борщ 	                  	noun:m:v_naz                                
у 	                       	prep:rv_mis:v-u
хлібі 	                 	noun:m:v_mis
був 	                    verb:past:m:imperf
зовсім  	           	adv
холодний 	         	adj:m:v_zna:compb						
куряча 	              	adj:f:v_naz
грудка 	                  noun:f:v_naz
з 	                        	prep:rv_oru
грибним 	          	adj:m:v_oru                                
соусом  	                noun:m:v_oru
і         	              	conj:coord
рисом 	                  	noun:m:v_oru
теж 	                 	part
холодна 	   adj:f:v_zna:compb
А 	                          	conj:coord                               
смажена 	         	adjp:pasv:past:f:v_naz
картопля 	            noun:f:v_naz
мабуть 	                 	insert
смажилась 	        	verb:rev:past:f:imperf
за 	                          prep:rv_zna
день 	                 	noun:m:v_zna
до       	                	prep:rv_rod
замовлення 	         	noun:n:v_rod
Але 	                  	conj:coord                               
найбільше 	             adv:super
образило 	         	verb:past:n:perf
те                           pron:dem                          
що       	               	conj:subord                                
фірмові 	         	adj:p:v_naz                                
вареники 	          	noun:p:v_naz                                
з         	                	prep:rv_oru
вишнями 	            	noun:p:v_oru
які 	        conj:subord                                
замовляли 	           verb:past:p:imperf
дитині 	                 	noun:f:v_dav:anim                                						
були 	                    verb:past:p:imperf
недоварені 	      	adj:p:v_zna                                
Була 	                    verb:past:f:imperf
кращої 	              	adj:f:v_rod:compr
думки    	             	noun:f:v_rod							
але 	                	    conj:coord                                
тепер 	                 	adv
дуже     	                adv                
розчарована      adjp:pasv:past:f:v_zna
Ресторан      	 	    noun:m:v_naz                                
дійсно   	              adv
чудовий 	      	    adj:m:v_zna:compb                                
Ціни 	                    noun:f:v_naz                             
доступні 	     	    adj:p:v_zna:compb                               
кожному 	              pron:def                               							
до       	                  prep:rv_rod
відвідувачів 		    noun:p:v_rod:anim                                
відносяться     	    verb:rev:pres:p:3:imperf
з         	                	prep:rv_oru
повагою 	            	noun:f:v_oru
А 	                        	conj:coord                                
головне 	    adv                  							
це      	              	pron:dem						
сімейна 	    	    adj:f:v_naz
атмосфера 	    	    noun:f:v_naz
яку 	      conj:subord             
не        	                  part
в          	                  prep:rv_mis:v-u
кожному 	       	    pron:def                                
ресторані 	    	    noun:m:v_mis
можна 	            	    predic
відчути 	      	    verb:inf:perf
І              	               conj:coord                                
обов'язково     	    adv
скуштуйте 	    	    verb:impr:p:2:perf
вареники 	       	    noun:p:v_zna
з 	                           prep:rv_oru
вишнями 	       	    noun:p:v_oru
й 	                     	    conj:coord                                
сметаною 	     	    noun:f:v_oru
ось 	                    	part
про      	         	    prep:rv_zna
це      	         	    pron:dem                                
ви 	                       	pron:pers:p:2:v_naz:anim
точно    	            	adv
не       	               	part
пожалкуєте 	    	    verb:futr:p:2:perf
Львівська 	       	adj:f:v_naz
майстерня 	          	noun:f:v_naz
шоколаду 	          	noun:m:v_rod
просто 	             	    adv:compb                                                            
і 	                        	conj:coord                                
взагалі 	       	    adv:v-u
це 	                       	pron:dem
класно 	              	adv 
Я 	                        	pron:pers:s:1:v_naz:anim
б 	                        	part
її                          pron:pers:f:3:v_zna:anim                                
всю 	                 	pron:dem
з'їла 	              	verb:past:f:perf
Шоколад            	    noun:m:v_naz                                
тут 	                     adv
насправді 	     	    adv                                
дуже 	                    adv                
смачний 	      	    adj:m:v_zna:compb                                
і         	            	    conj:coord                                
дуже 	                    adv                
якісний 	     	    adj:m:v_zna:compb                               
Краще 	       adv   
з'їсти 	                  verb:inf:perf
щось     	             	pron:ind:n:v_zna
але 	                     conj:coord                                
якісне 	          	    adj:n:v_zna:compb                                						
ніж 	                 	conj:subord                                
дешеве 	          	    adj:n:v_naz:compb                                
і 	                        	conj:coord                                
порошок 	     	    noun:m:v_naz                                
 І	                        	conj:coord                                
великий 	          	adj:m:v_naz:compb                                
асортимент 	       	noun:m:v_naz                                
товару   	            	noun:m:v_rod
І 	                        	conj:coord
персонал 	     	    noun:m:v_naz                                
тут 	                     adv
також 	            	    adv                                
дуже     	                adv                
привітний 	    	    adj:m:v_naz:compb                                
і           	        	    conj:coord                                
уважний 	      	    adj:m:v_zna:compb                                
Давненько 	           adv
я         	               	pron:pers:s:1:v_naz:anim
вже 	                 	adv:v-u
не        	               	part
заїжджав 	    	    verb:past:m:imperf
в          	             	    prep:rv_zna:v-u
Батьківську     	adj:f:v_zna
хату 	                    noun:f:v_zna
Все 	                     pron:dem                                
якось 	                   pron:ind
не 	                   	    part
має 	                    verb:pres:s:3:imperf                
часу 	              	    noun:m:v_rod
Але 	               	    conj:coord                                
останній 	         	adj:m:v_naz
раз 	                  	oun:m:v_naz
коли     	                conj:subord
я         	                   pron:pers:s:1:v_naz:anim
там 	                  	adv                                
був 	            	    verb:past:m:imperf
залишився 	    	    verb:rev:past:m:perf
задоволеним     	    adjp:pasv:past                                
і 	                   	    conj:coord                                
ситим 	                	adj:m:v_oru                                							
як           	       	    conj:subord                                
і 	                        	 part
завжди  	       	    adv
Офіціанти    		    noun:p:v_naz:anim
ввічливі 	    	    adj:p:v_zna:v-u							
заказ 	       
приносять 	    	    verb:pres:p:3:imperf
вчасно  	              adv
Не 	                          part
знаю 	                   verb:pres:s:1:imperf
можливо 	      	    adv
у        	             	    prep:rv_rod:v-u
них 	             	    pron:pers:p:3:v_rod:anim
щось     	                pron:ind:n:v_zna
змінилося 	    	    verb:rev:past:n:perf
але 	              	    conj:coord
надіюсь 	    	    verb:rev:pres:s:1:imperf
що         	               	conj:subord                               
на 	                       	part                                
краще 	         	    adj:n:v_zna:compr
Адже 	            	    part
Поплавський     	    noun:m:v_naz:anim:lname
все 	                     pron:dem                                
робить   	              verb:pres:s:3:imperf
для 	                     prep:rv_rod
того 	                     pron:dem                                						
щоб 	                  	conj:subord
клієнт   	       	    noun:m:v_naz:anim
почував 	    	    verb:past:m:imperf
себе 	            	    pron:refl:m:v_rod                                
комфортно 	    	    adv:compb
Так 	                      part
була 	                    verb:past:f:imperf
В 	               	        prep:rv_rod:v-u
майстерні 	           noun:f:v_rod                                
класно 	         	        adv
Ну       	       	        excl                                
ціни 	                    noun:p:v_naz                              
шоковані 	       	adjp:pasv:past:p:v_zna                                
Піду 	             	    verb:futr:s:1:perf
думаю 	           	    verb:pres:s:1:imperf
куплю 	           	    verb:futr:s:1:perf
плитки 	           	    noun:f:v_zna                                
шоколаду 	             noun:m:v_rod                                
У 	                    	    prep:rv_dav:v-u
висновку 	     	    noun:m:v_dav                                
цукерки 	      	    noun:p:v_naz                                
по       	              	prep:rv_mis:rv_zna
Якщо 	                    conj:subord
хочете 	           	    verb:unknown
поласувати    		    verb:inf:perf
більше 	                  adv:compr                
беріть 	                	verb:impr:p:2:imperf
купу 	                 	noun:f:v_zna
грошей   	        	    noun:p:v_rod
Ціни 	                    noun:p:v_naz                               
просто            	    adv:compb
добивають 	    	    verb:pres:p:3:imperf
Ну 	                  	    excl
так 	                  	part
на      	              	 prep:rv_zna
подарунок 	    	    noun:m:v_zna				
гідно    	        	    adv:compb	
щось 	            	    pron:ind:n:v_zna
таке 	           	    pron:def  
бо 	                       	conj:subord
дійсно   	           	adv
смачно 	              	adv:compb
Але 	        part      
якщо 	             	    conj:subord
собі 	             	    pron:refl:m:v_dav                                
взяти   	        	    verb:inf:perf
каву     	             	noun:f:v_zna
шоколад 	      	    noun:m:v_zna                                
трохи     	               adv
цукерок 	      	    noun:p:v_rod
то 	                       	conj:subord
грн 	                  	nun:p:v_naz:nv:abbr                                
за        	                  prep:rv_zna
задоволення     	    noun:n:v_zna
сидіти   	           	verb:inf:imperf
у            	            	prep:rv_zna:rv_mis:rv_rod:v-u
вічному 	           	adj:n:v_mis
натовпі 	              noun:m:v_mis
внизу    	        	    adv:v-u
то 	                  	    conj:subord
просто  	       	    adv:compb                               
дорого  	          	adv:compb
Нагорі    	              adv
надзвичайно     	    adv
романтично 	          adv:compb
просто 	           	    adv:compb
казка   	       	    noun:f:v_naz
якщо    	         	    conj:subord
приходиш 	    	    verb:pres:s:2:imperf
вперше   	       	    adv:v-u
Але 	             	    conj:coord
щоразу    	       	    adv
нічого   	                pron:neg:v_zna                                
крім 	                    prep:rv_rod
кави 	             	    noun:f:v_rod
немає    	               predic
самі 	                     pron:def                
кавові 	              	adj:p:v_naz
напої 	                   noun:p:v_naz                                
зроблені 	        	 adjp:pasv:past:p:v_zna
абияк 	                   adv
щоб 	                  	conj:subord
відчепились     	    verb:rev:past:p:perf
і             	            	conj:coord
поскоріше 	           adv:compr
забрались 	    	    verb:rev:past:p:perf
Дорого 	                  adv:compb
несмачно 	         	adv
і 	                     	    conj:coord
незатишно 	           adv
насправді 	    	    adv
Сумно 	            	    adv:compb
у         	            	    prep:rv_rod:v-u
столиці 	      	    noun:f:v_rod                                
кави 	                 	noun:f:v_rod
смачну 	          	    adj:f:v_zna:compb
і 	                     	    conj:coord
доступну 	    	    adj:f:v_zna:compb
за 	                     	    prep:rv_oru
ціною   	        	    noun:f:v_oru
каву 	             	    noun:f:v_zna
попити 	                  verb:inf:perf                
зараз 	                   adv               
стає     	     	    verb:pres:s:3:imperf
проблемою 	     	    noun:f:v_oru
Ніяк 	                 	pron:neg
не         	          	    part
можу 	           	    verb:unknown
відійти 	      	    verb:inf:perf
від 	              	    prep:rv_rod
обурення 	     	    noun:n:v_rod
Сьогодні 	     	    adv
була 	                    verb:past:f:imperf
в         	          	    prep:rv_zna:v-u
майстерні 	           noun:f:v_zna                                
вперше 	           	    adv:v-u
Купувала 	    	    verb:past:f:imperf
коробки 	     	    noun:f:v_zna
цукерок 	          	noun:p:v_rod
на 	                  	    prep:rv_zna
подарунок 	    	     noun:m:v_zna
і 	                       	conj:coord
для 	                  	prep:rv_rod
себе 	                	pron:refl:m:v_rod                                
попробувати       	verb:inf:perf
Ще 	                          part
подумала 	    	    verb:past:f:perf
розраховуючись 		advp:rev:imperf
на        	          	    prep:rv_mis
касі 	             	    noun:f:v_mis						
що       	               	conj:subord                               
вийшло   	       	    verb:past:n:pasv
дорожче     	  	    adj:n:v_zna:compr                                			
ніж 	              	    conj:subord                                
підрахувала     	    verb:past:f:perf
Але 	                  	conj:coord
дуже 	                    adv               
спішилась 	     	    verb:rev:past:f:imperf                                				
тому 	                    conj:subord
заплатила 	    	    verb:past:f:perf
і 	                  	    conj:coord
не      	               	part
передивлялась   	verb:rev:past:f:imperf
чек          	          	noun:m:v_zna
Коли 	                    conj:subord                               
ж 	                        	part
прийшла 	       	    verb:past:f:perf
додому 	           	    adv
подивилась 	    	    verb:rev:past:f:perf
чек 	                  	noun:m:v_zna
і         	              	conj:coord
перерахувала 		verb:past:f:perf
виявилось 	    	    verb:rev:past:n:perf
що       	          	    conj:subord                                
мені 	                    	pron:pers:s:1:v_dav:anim
дописали 	    	    verb:past:p:perf
цукерок 	     	    noun:p:v_rod
Кожна     	        	    pron:def
коштує   	    	    verb:pres:s:3:imperf
грн 	             	    noun:f:v_dav:nv:abbr                               
і         	                 	conj:coord
того 	                  	pron:dem                                
Звичайно 	            adv:compb
сама 	                     pron:def
лох 	                	    noun:m:v_naz                               
печальний 	    	    adj:m:v_zna			
але 	              	    conj:coord
звикла                   verb:past:f:perf
людям 	             	    noun:p:v_dav:anim
довіряти        	    verb:inf:imperf
Більше    	              adv:compr                
ніколи 	                	adv
туди 	                   	adv
не 	                      	part
піду 	             	    verb:futr:s:1:perf
і 	                    	    conj:coord
знайомим 	    	    adj:p:v_dav
буду 	                    verb:futr:s:1:imperf
розповідати      	verb:inf:imperf
як      	             	    conj:subord                                
там 	              	    adv
дурять 	           	    verb:pres:p:3:imperf
А 	                  	    part
всім     	            	pron:dem                              
раджу 	                  verb:pres:s:1:imperf
ретельно 	            adv:compb
передивлятись   	verb:rev:inf:imperf
чек      	          	    noun:m:v_zna
і            	             	conj:coord
рахувати 	    	    verb:inf:imperf
кількість 	    	    noun:f:v_zna
цукерок 	    	        noun:p:v_rod
що 	                    	    conj:subord                                
берете   	       	    verb:pres:p:2:imperf
Перший 	                  adj:m:v_naz  
раз 	                     noun:m:v_naz
була 	                    verb:past:f:imperf
у 	                    	    prep:rv_zna:v-u
Львові 	        Львів noun:m:v_zna
жовтня         	  	    noun:m:v_rod
року 	                     noun:m:v_rod
з 	            	            prep:rv_rod
приводу                   noun:m:v_rod
турніру         	        noun:m:v_rod
Чемпіонат 	    	    noun:m:v_naz                                
України 	          	noun:f:v_rod                                
серед 	                   prep:rv_rod
Молоді 	                  noun:f:v_rod
зі 	                          prep:rv_rod
спортивно 	    	    adv
бального 	      	    adj:m:v_rod
танцю    	          	noun:m:v_rod 					
Перед 	                	noun:m:v_oru
від'їздом 	          	noun:m:v_oru
звісно 	           	    adv
я 	                     	    pron:pers:s:1:v_naz:anim
з 	                   	    prep:rv_oru
друзями 	        	    noun:p:v_oru:anim
вирішили 	    	    verb:past:p:perf
відвідати 	    	    verb:inf:perf
славнозвісну    	adj:f:v_zna
шоколадну 	     	    adj:f:v_zna
майстерню 	    	    noun:f:v_zna
скуштувати  		    verb:inf:perf
смачної 	      	    adj:f:v_rod:compb
кави 	                    noun:f:v_rod
і 	                    	    conj:coord
придбати 	    	    verb:inf:perf
шоколадних   		    adj:p:v_rod
виробів 	    	        noun:p:v_rod
На 	                       	prep:rv_mis
першому 	    	        adj:n:v_mis
поверсі 	        	    noun:m:v_mis
нам 	               	    pron:pers:p:1:v_dav:anim
зварили 	      	    verb:past:p:perf
дуже 	                    adv               
смачну 	              	adj:f:v_zna:compb
каву 	            	    noun:f:v_zna
дійсно 	           	    adv
таку 	            	    pron:def
я 	                   	    pron:pers:s:1:v_naz:anim
ще 	                   	    part
не 	                       	part
пила 	                	verb:past:f:imperf
в 	                       	prep:rv_misv-u
своєму 	             	    pron:pos
житті 	                	noun:n:v_mis
і            	            	conj:coord
вразили 	      	    verb:past:p:perf
хлопці 	          	    noun:p:v_naz:anim
консультанти         noun:p:v_naz:anim
дуже 	                    adv
виховані 	    	    adjp:pasv:past:p:v_zna
та 	                      	conj:coord
приємні 	    	    adj:p:v_naz:compb											
Все 	                     pron:v-u
було 	                    verb:past:n:imperf
б 	               	        part
гаразд 	        adv
але 	                  	conj:coord
нам 	                	    pron:pers:p:1:v_dav:anim
ще       	           	    part
потрібно 	    	    adv:compb
було 	            	    verb:past:n:imperf
придбати 	    	    verb:inf:perf
шоколад 	    	    noun:m:v_zna
у 	                     	    prep:rv_mis:v-u
виді 	              	    noun:m:v_mis
сувеніру 	       	    noun:m:v_rod
виготовлений    	adjp:pasv:past:m:v_zna
на        	              	prep:rv_zna:rv_mis
наш 	              	    pron:pos
смак 	                	 noun:m:v_zna
цікавий 	          	adj:m:v_naz:compb
для 	                  	prep:rv_rod
дітей 	             	    noun:p:v_rod:anim 	
Хлопці 	              	noun:p:v_naz:anim
запропонували 		verb:past:p:perf
нам 	               	    pron:pers:p:1:v_dav:anim
піднятися 	    	    verb:rev:inf:perf
на 	                   	    prep:rv_zna
другий 	               	adj:m:v_zna
поверх 	              	noun:m:v_zna                                
в 	                  	        prep:rv_zna:v-u
магазин 	       	    noun:m:v_zna
що 	                   	    conj:subord
ми        	               	pron:pers:p:1:v_naz:anim
й 	                        	conj:coord
зробили 	      	    verb:past:p:perf
вислухавши 	           advp:perf
наше 	              	    pron:pos
замовлення 	    	    noun:n:v_zna
консультант       	noun:m:v_naz:anim
дівчина 	      	    noun:f:v_naz:anim
послала 	     	    verb:past:f:perf
нас 	        	            pron:pers:p:1:v_zna:anim
на      	                  prep:rv_zna
третій 	               	 adj:m:v_zna
поверх 	            	     noun:m:v_zna                               
нібито 	               	conj:subord
там 	                  	pron:dem
приймають 	    	    verb:pres:p:3:imperf
замовлення 	    	     noun:n:v_zna                                
з 	                         	prep:rv_rod
третього 	       	    adj:m:v_rod
поверху 	           	noun:m:v_rod
нас 	                   	pron:pers:p:1:v_rod:anim
направили 	         	verb:past:p:perf
знову 	                 	adv
на 	                 	    prep:rv_zna
другий    	       	    adj:m:v_zna
кажучи 	           	    advp:imperf
що 	                   	    conj:subord                                
там 	                  	adv
більший 	             adj:m:v_zna:compr
вибір    	             	 noun:m:v_zna
нам 	                    	pron:pers:p:1:v_dav:anim
хотілось 	    	    verb:unknown
як 	                   	     part
найшвидше 	              adv:super
зробити 	     	    verb:inf:perf
замовлення   	     	noun:n:v_zna                                
адже           	         	conj:subord
двоє 	               	numr:p:v_zna
не 	                        	part
спавши 	                   advp:perf
були 	             	    verb:past:p:imperf
втомлені 	    	    adjp:pasv:past:p:v_zna:v-u
і 	                         	conj:coord
от                         	part
ми       	               	pron:pers:p:1:v_naz:anim
попали 	              	verb:past:p:perf
в 	                    	    prep:rv_zna:v-u
руки 	             	    noun:f:v_zna                                
ЧУДОВОГО 	         	adj:m:v_rod:compb
КОНСУЛЬТАНТА         noun:m:v_rod:anim
дівчину 	     noun:f:v_rod:anim
взагалі 	             adv:v-u
назвала 	         	verb:past:f:perf
нас 	               	    pron:pers:p:1:v_rod:anim
наркоманами     	    noun:p:v_oru:anim
бо 	                   	    conj:subord
тільки  	            	part
вживаючи 	       	    advp:imperf:v-u
наркотики 	    	    noun:p:v_zna
за 	                       	prep:rv_oru
її 	                        pron:pers:f:3:v_zna:anim
словами 	           	noun:p:v_oru
можна 	            	    predic
так 	                 	part
довго 	           	    adv:compb
не 	                          part
спати 	                	verb:inf:imperf
потім 	           	    adv
сказала 	      	    verb:past:f:perf
що       	            	    conj:subord
її                          pron:pers:f:3:v_zna:anim
вже 	                  	adv:v-u
всі 	                	pron:dem
задовбали 	         	verb:past:p:perf
що 	                   	    conj:subord
вона 	            	    pron:pers:f:3:v_naz:anim
вже                   	    adv:v-u
втомилась    		    verb:rev:past:f:perf:v-u
і 	                    	    conj:coord
краще 	                     adv
її 	                        pron:pers:f:3:v_zna:anim
не       	                  part
чіпати 	           	    verb:inf:imperf
сказала 	       	    verb:past:f:perf
що             	       	    conj:subord
вона 	                  	pron:pers:f:3:v_naz:anim
шостий 	              	adj:m:v_zna
день 	                	noun:m:v_zna
взагалі 	          	adv:v-u
працює   	     	    verb:pres:s:3:imperf
там 	        	            adv
і 	                    	    conj:coord
нічого  	              adv
не 	                       	part
знає 	            	    verb:pres:s:3:imperf
такого   	           	adj:n:v_rod
хамства 	         	noun:n:v_rod
я 	                    	    pron:pers:s:1:v_naz:anim
в 	                     	    prep:rv_mis:v-u
житті 	                   noun:n:v_mis
не 	                    	    part
бачила 	           	    verb:past:f:imperf
хоча 	              	    conj:subord
сама 	                   adj:f:v_naz
працюю 	        	    verb:pres:s:1:imperf
в 	                    	    prep:rv_mis:v-u
торгівлі 	     	    noun:f:v_mis	
Не 	                       	part
добившись	    	    advp:rev:perf
взагалі 	       	    adv:v-u
розуміння 	    	    noun:n:v_rod                                
консультантів   	    noun:p:v_rod:anim
які 	                conj:subord
сказали 	         	verb:past:p:perf
що 	                   	    conj:subord
цех 	                  	noun:m:v_naz
вже 	                 	adv:v-u
не       	                  part
працює 	        	    verb:pres:s:3:imperf
і            	         	    conj:coord
нічого 	                    pron:neg:v_zna
нам 	               	    pron:pers:p:1:v_dav:anim
не 	                          part
будуть 	             	    verb:futr:p:3:imperf
виготовляти      	verb:inf:imperf
хоча 	             	    conj:subord
ми       	              	pron:pers:p:1:v_naz:anim
пропонували      	verb:past:p:imperf
не          	       	    part
малу 	            	    adj:f:v_zna:compb
суму 	                    noun:f:v_zna
грошей 	                   noun:p:v_rod
ми        	          	    pron:pers:p:1:v_naz:anim
розвернулись     	verb:rev:past:p:perf
і 	                   	    conj:coord
пішли    	         	    verb:past:p:perf	
на 	                       	 prep:rv_zna
наше 	               	    pron:pos
прохання 	    	    noun:n:v_zna
покликати 	    	    verb:inf:perf
менеджера 	    	    noun:m:v_rod:anim
не        	              	part
відреагували    	verb:past:p:perf
ніяк 	              	    adv
Жахливе 	    	    adj:n:v_naz:compb
враження 	         	noun:n:v_naz
від 	                 	prep:rv_rod
відношення 	    	    noun:n:v_rod
до 	                      	prep:rv_rod
туристів 	          	noun:p:v_rod:anim	
Сама 	                     pron:def                
я            	        	    pron:pers:s:1:v_naz:anim
з 	                      	    prep:rv_rod
міста 	            	    noun:n:v_rod
Житомира 	          	noun:m:v_rod
де 	                      	pron:int:rel                                
також 	               	adv
є 	                 	    verb:pres:p:3:imperf
шоколадна 	    	    adj:f:v_naz
майстерня 	    	    noun:f:v_naz
де 	                   	    pron:int:rel                                
будь-яке 	    	    pron:ind
замовлення 	    	    noun:n:v_zna
з 	                        	prep:rv_oru
радістю 	      	    noun:f:v_oru
виготовляють     	verb:pres:p:3:imperf
і 	                   	    conj:coord
дуже 	                    adv
чемні 	               	adj:p:v_naz:compb
консультанти 		    noun:p:v_naz:anim 						
Всім 	        	        pron:dem
знайомим 	    	    noun:m:v_oru:anim
вже 	                     adv:v-u
розповіла 	    	    verb:past:f:perf
своє 	                    pron:pos
враження 	    	    noun:n:v_zna						
Був 	                    verb:past:m:imperf	
там 	                    	adv	
на       	           	    prep:rv_zna	
новорічні 	    	    adj:p:v_zna	
свята                   	 noun:p:v_zna
Жахливе 	    	    adj:n:v_naz:compb
враження 	    	    noun:n:v_naz                                								
людей 	                	noun:p:v_rod:anim
запускають 	       	verb:pres:p:3:imperf	
з 	                   	    prep:rv_rod
черги 	             	    noun:f:v_rod							
народу  	        	    noun:m:v_rod	
як        	               	 conj:subord
оселедців 	    	    noun:p:v_rod:anim	
у 	                       	prep:rv_mis:v-u	
діжці 	            	    noun:f:v_mis							
дихати 	           	    verb:inf:imperf
нема 	                    predic	
чим 	              	    pron:int:rel:n:v_oru
намагався 	         	verb:rev:past:m:imperf
придбати 	    	    verb:inf:perf
цукерок 	          	noun:p:v_rod
але 	              	    conj:coord
гості    	               noun:p:v_naz:anim
з 	                       	prep:rv_rod
Росії    	        	     noun:f:v_rod								
яких 	             	    pron:int:rel:def
дуже 	                    adv	
багато 	           	    adv
мені 	                    	pron:pers:s:1:v_dav:anim
цього 	                   	pron:dem
не        	          	    part
дали 	             	    verb:past:p:perf
відпихаючи 	    	    advp:imperf
кожного 	          	pron:def
з 	                        	prep:rv_rod
черги 	                	noun:f:v_rod                              
Але 	                     conj:coord
мені 	                    	pron:pers:s:1:v_dav:anim
вдалося 	          	verb:rev:past:n:perf:v-u
придбати 	    	    verb:inf:perf
десь 	            	     part
півтора 	          	numr:m:v_zna:nv
кіло 	       noun:m:v_zna	
шматкового    		    adj:m:v_rod
шоколаду 	          	noun:m:v_rod							
дуже 	                    adv
смачний 	          	adj:m:v_naz:compb	
до 	            до речі         <insert>          
Хоч 	                  	conj:subord
далеко  	       	    adv:compb
не 	                          part
дешевий 	      	    adj:m:v_naz:compb
Взагалі 	        adv  	  
я 	                     	    pron:pers:s:1:v_naz:anim
приїду 	          	    verb:futr:s:1:perf
сюди 	              	    adv
коли                         conj:subord						        
не       	               	part
буде 	             	    verb:futr:s:3:imperf
такого       	    	    pron:def
ажіотажу 	          	noun:m:v_rod
всі 	             	    pron:dem
говорять 	    	    verb:pres:p:3:imperf
що                     	    conj:subord
дуже 	                    adv
файне 	               	adj:n:v_naz
місце 	                	noun:n:v_naz
Класне 	             	adj:n:v_naz
місце 	               	noun:n:v_naz
Смачна      	     	adj:f:v_naz:compb
кава 	                 	noun:f:v_naz
затишна 	            adj:f:v_naz:compb
обстановка 	       	noun:f:v_naz
чисто 	                	adv:compb
привітливі       	adj:p:v_naz
працівники 	       	noun:p:v_naz:anim
свіжі 	               	adj:p:v_naz:compb
квіти        	        	noun:p:v_naz
на           	           	preprv_mis
столиках    	      	noun:p:v_mis
швидке       	       	adj:n:v_naz:compb
обслуговування 		noun:n:v_naz
помірні 	            adj:p:v_naz
ціни 	                    noun:p:v_naz
Ну           	             	excl                                
і 	                      	 part
звісно      	          adv
ж            	           	 part
гордість 	        	noun:f:v_naz
кав'ярні 	        	noun:f:v_rod
шоколад 	          	noun:m:v_naz
Я                        	pron:pers:s:1:v_naz:anim
не 	                          part
є            	        	verb:pres:p:1:imperf                                
прихильником 	  	noun:m:v_oru:anim
чорного 	           	adj:m:v_rod:compb
шоколаду       	      	noun:m:v_rod
але 	                  	conj:coord
одного        	        	numr:n:v_rod
разу 	                  	noun:m:v_rod
я 	                          pron:pers:s:1:v_naz:anim
зайшов 	                 	verb:past:m:perf
до 	                        	prep:rv_rod
кондитерської 	    noun:f:v_rod
і 	                        	conj:coord
замовив 	           	verb:past:m:perf
каву 	                 	noun:f:v_zna
Безперечно   	   	 insert
купив 	                  verb:past:m:perf
цукерки 	           	 noun:p:v_zna
До          	              prep:rv_rod
кави 	                	noun:f:v_rod
подали      	      	verb:past:p:perf
маленьку 	        	adj:f:v_zna
цукерку     	         noun:f:v_zna
з            	            	prep:rv_rod
чорного 	           	adj:m:v_rod:compb
шоколаду     	      	noun:m:v_rod
Я 	                        	pron:pers:s:1:v_naz:anim
спробував    	   	verb:past:m:perf
це           	          	pron:dem
неймовірний 	 	adj:m:v_naz:compb
смак 	                 	noun:m:v_naz
я 	                        	pron:pers:s:1:v_naz:anim
закохався 	       	verb:rev:past:m:perf
у 	                         	prep:rv_zna:v-u
цей 	                 	 pron:dem
смак        	         	noun:m:v_zna
Щоправда 	         	insert
тоді         	         	adv     
я             	            	pron:pers:s:1:v_naz:anim
так         	          	pron:dem
наївся       	    	verb:rev:past:m:perf
чорного 	            	adj:m:v_rod:compb                                
шоколаду    	       	noun:m:v_rod
що           	           	conj:subord
погано       	       	adv:compb
почував 	            verb:past:m:imperf
себе 	                 	pron:refl:m:v_rod
але          	          	conj:coord
той 	                 	pron:dem
смак          	         	noun:m:v_naz
був 	                    verb:past:m:imperf
неймовірним 	  	adj:m:v_oru:compb 
Раджу 	                 verb:pres:s:1:imperf
завітати 	        	verb:inf:perf














