Кілька	             		noun:f:v_naz:anim (numr:p:v_rod:&pron:ind )
разів	                	noun:p:v_rod 
замовляв	            	verb:past:m:imperf 
тут	                    	adv:&pron:dem 
пиво	                	noun:n:v_zna 
і	                    	conj:coord  
щоразу	                	adv 
був	                    	verb:past:m:imperf 
прикро	                	adv:compb 
вражений	            	adjp:pasv:past:m:v_naz 
його	                	adj:n:nv:&pron:pos
огидним	                	adj:n:v_oru:compb 
смаком	                	noun:m:v_oru 
насправді	            	adv
на	                    	prep:rv_zna:rv_mis 
смак                    	noun:m:v_zna 
не	                    	part 
такий	                	adj:m:v_naz:&pron:def 
як	                    	adv:&pron:int:rel 
наливають	            	verb:pres:p:3:imperf 
у	                    	prep:rv_zna:rv_mis:rv_rod:v-u 
вас	                        pron:pers:p:2:v_mis:anim 
в	                        prep:rv_zna:rv_mis:rv_rod:v-u 
закладі	                    noun:m:v_mis 
Була	                    verb:past:f:imperf 
вчора	                    adv:v-u 
в	                        prep:rv_zna:rv_mis:rv_rod:v-u 
цьому	                    adj:n:v_mis:&pron:dem 
закладі	                    noun:m:v_mis 
Не	                        part 
рекомендую	                verb:pres:s:1:imperf 
його	                    pron:pers:m:3:v_zna:anim
відвідувати	                verb:inf:imperf 
Обслуговування	   			noun:n:v_naz 
жахливе      	        	adj:n:v_naz:compb 
прийшла	                  	verb:past:f:perf 
офіціантка	           		noun:f:v_naz:anim 
і	                        conj:coord 
я	                        pron:pers:s:1:v_naz:anim
її	                        pron:pers:f:3:v_zna:anim
розпитувала	          		verb:past:f:imperf 
про	                        prep:rv_zna 
страви	                    noun:p:v_zna 
Вона	                    pron:pers:f:3:v_naz:anim 
випадково	            	adv 
мені	                    pron:pers:s:1:v_dav:anim 
сказала	                    verb:past:f:perf 
не	                        part 
той	                        adj:m:v_zna:&pron:dem 
опис	                    noun:m:v_zna 
супу	                    noun:m:v_rod 
ну	                        excl 
і            	            conj:coord 
в	                        prep:rv_zna:rv_mis:rv_rod:v-u 
результаті	            	noun:m:v_mis 
замість	                  	prep:rv_rod 
легенького	            	adj:m:v_rod
я	                        pron:pers:s:1:v_naz:anim 
отримала	             	verb:past:f:perf 
суміш	                    noun:f:v_zna 
перців         	            noun:p:v_rod 
дуже	                    adv 
гострий	                  	adj:m:v_naz:compb 
і              	            conj:coord 
за	                        prep:rv_rod:rv_zna:rv_oru 
години	                   	noun:f:v_rod
часу	                    noun:m:v_rod 
Стейк	                    noun:m:v_naz 
ми	                        pron:pers:p:1:v_naz:anim 
на	                        prep:rv_zna 
нього	                    pron:pers:m:3:v_zna:anim
чекали         	            verb:past:p:imperf 
1	                        number 
годину	                   	noun:f:v_zna 
10	                        number 
хвилин	                    noun:p:v_rod 
таке	                    adj:n:v_naz:&pron:def 
враження       	         	noun:n:v_naz 
що             	            conj:subord
вони	                    pron:pers:p:3:v_naz:anim 
просто       	           	adv:compb
забули	                   	verb:past:p:perf 
про	                        prep:rv_zna 
замовлення	           		noun:n:v_zna 
стейк	                    noun:m:v_naz 
був	                        verb:past:m:imperf 
добре	                    adv
прожарений	           		adjp:pasv:past:m:v_naz 
але	                        conj:coord
дуже	                    adv 
солений	                  	adjp:pasv:past:m:v_naz
я	                        pron:pers:s:1:v_naz:anim 
ще	                        part 
так	                        adv:&pron:dem
довго          	            adv:compb 
в	                        prep:rv_mis:v-u 
жодному	                   	adj:n:v_mis:&pron 
закладі        	           	noun:m:v_mis 
не	                        part 
чекала	                   	verb:past:f:imperf 
на	                        prep:rv_zna:rv_mis 
стейк	                    noun:m:v_zna 
До	                        prep:rv_rod 
мого	                    adj:n:v_rod:&pron:pos 
замовлення	          		noun:n:v_rod  
ще            	            part 
входив       	          	verb:past:m:imperf 
салат	                    noun:m:v_naz 
який         	            adj:m:v_zna:&pron:int:rel:def
я	                        pron:pers:s:1:v_naz:anim 
так	                        adv:&pron:dem
і	                        part 
не	                        part 
дочекалась	           		verb:rev:past:f:perf 
Коли	                    conj:subord 
прийшли	                   	verb:past:p:perf 
по           	            prep:rv_zna 
рахунок      	          	noun:m:v_zna 
то	                        conj:subord 
салат	                   	noun:m:v_zna 
вони	                    pron:pers:p:3:v_naz:anim 
включили	             	verb:past:p:perf:v-u 
в	                        prep:rv_zna:v-u 
рахунок     	          	noun:m:v_zna 
бо                          conj:subord
він                         pron:pers:m:3:v_naz:anim 
був	                       	verb:past:m:imperf 
замовлений	           		adjp:pasv:past:m:v_naz 
Ну	                        excl
звісно	                  	adv 
коли	                    conj:subord 
я            	            pron:pers:s:1:v_naz:anim 
сказала	                 	verb:past:f:perf 
що	                        conj:subord 
його         	            pron:pers:m:3:v_zna:anim
так         	            adv:&pron:dem 
і             	            part 
не           	            part 
принесли	             	verb:past:p:perf 
то	                        conj:subord 
вони	                    pron:pers:p:3:v_naz:anim 
про	                        prep:rv_zna 
це	                     	adj:n:v_naz:&pron:dem (part)
згадали      	          	verb:past:p:perf 
і	                        conj:coord 
зразу                       adv 
відняли      	          	verb:past:p:perf 
від	                        prep:rv_rod 
суми	                    noun:f:v_rod 
Моя          	            adj:f:v_naz:&pron:pos 
оцінка         	           	noun:f:v_naz 
2	                        number 
Дуже	                    adv
хороший	                  	adj:m:v_naz:compb
заклад	                   	noun:m:v_naz 
приємно	                  	adv:compb 
здивований	           		adjp:pasv:past:m:v_naz
Був	                        verb:past:m:imperf 
і	                        conj:coord 
в           	            prep:rv_zna:v-u 
Гриль	                    noun:m:v_zna 
і	                        conj:coord
в              	            prep:rv_zna:rv_mis:rv_rod:v-u 
Мексиканець	         		noun:m:v_naz:anim (noun:m:v_zna:anim )
Приємно      	         	adv:compb 
здивували	           		verb:past:p:perf 
ціни	                    noun:p:v_naz 
як	                        conj:subord 
на            	            noun:m:v_zna 
Львова        	            noun:m:v_rod 
ціни	                    noun:p:v_naz 
на	                        prep:rv_zna:rv_mis 
алкоголь	             	noun:m:v_zna 
дуже         	            adv
привабливі	          		adj:p:v_naz:compb
звісно	                   	adv 
ж	                        part 
морожене	          		adjp:pasv:past:n:v_naz
але	                        conj:coord
за	                        prep:rv_rod:rv_zna:rv_oru
таку	                    adj:f:v_zna:&pron:def 
ціну	                    noun:f:v_zna 
30-40	                    number 
грн	                        noun:p:v_zna:nv:abbr 
за           	            prep:rv_zna
100	                        number 
нереально	           		adv 
знайти	                  	verb:inf:perf 
охолоджену	          		adjp:pasv:past:f:v_zna 
яловичину	            	noun:f:v_zna 
Лат	                        noun:m:v_naz (noun:f:v_rod)                                  
Америки	                 	noun:f:v_rod 
Отож	                   	part 
в	                        prep:rv_rod:v-u 
балансі	                   	noun:m:v_mis(noun:m:v_rod) 
ціна	                    noun:f:v_naz 
якість	                  	noun:f:v_naz 
стейки	                    noun:p:v_naz 
на	                        prep:v_mis 
висоті      	           	noun:f:v_mis 
Всім	               		adj:m:v_mis:&pron:dem (pron:pers:m:3:v_dav:anim)
раджу	                   	verb:pres:s:1:imperf 
приємний	             	adj:m:v_naz:compb
ввічливий	            	adj:m:v_naz:v-u
і            	            conj:coord
професійний	          		adj:m:v_naz:compb
Якщо	                    conj:subord 
не	                        part 
будуть	                    verb:futr:p:3:imperf 
рубати	                  	verb:inf:imperf 
ціни	                    noun:p:v_zna 
вверх	                 	adv:v-u 
це	                    	adj:n:v_naz:&pron:dem (part)
топовий                  	adj:m:v_naz
заклад      	           	noun:m:v_naz
в            	            prep:rv_mis:v-u 
центрі	                    noun:m:v_mis 
для	                        prep:rv_rod 
молоді	                  	noun:f:v_rod 
середнього	             	adj:m:v_rod 
достатку	            	noun:m:v_rod 
Дякую	                 	verb:pres:s:1:imperf 
Чудовий	                 	adj:m:v_naz:compb 
заклад	                   	noun:m:v_naz 
Неймовірно	           		adv:compb 
смачні	                  	adj:p:v_naz:compb 
та	                        conj:coord
великі         	         	adj:p:v_naz:compb
суші           	      		noun:p:v_naz
стейки	                   	noun:p:v_naz 
просто        	           	adv:compb 
пальчики	              	noun:p:v_zna 
оближеш	                	verb:futr:s:2:perf 
а	                        conj:coord 
пюре          	            noun:n:v_naz:nv 
з            	            prep:rv_oru
сиром          	            noun:m:v_oru 
просто	                   	adv:compb
бомба        	            noun:f:v_naz 
Завжди	                   	adv:&pron:gen 
ходжу        	         	verb:pres:s:1:imperf 
туди	                    adv:&pron:dem 
і	                        conj:coord
жодного	                  	adj:m:v_rod:&pron 
разу          	            noun:m:v_rod 
не           	            part 
розчарувалась	    		verb:rev:past:f:perf 
Вітаю	                  	verb:pres:s:1:imperf 
всіх           	       		adj:p:v_mis:&pron:dem (pron:pers:m:3:v_rod:anim)
приємно	               		adv:compb 
вражений	           		adjp:pasv:past:m:v_naz
відгуком       	           	noun:m:v_oru 
приємно	                 	adv:compb 
тим	                        adj:m:v_oru:&pron:dem
що            	            conj:subord 
не           	            part 
один	                    numr:m:v_naz
я             	            pron:pers:s:1:v_naz:anim 
такий	                  	adj:m:v_naz:&pron:def
прискіпливий 	     		adj:m:v_naz:compb 
дегустував   	      		verb:past:m:imperf
саме         	            part
у	                        prep:rv_mis:v-u 
вашому        	            adj:m:v_mis:&pron:pos 
закладі     	          	noun:m:v_mis 
пару          	            noun:f:v_zna 
тижнів	                 	noun:p:v_rod 
тому	                    adv
враження	             	noun:n:v_naz 
ідентичне    	       		adj:n:v_naz
концентрація	     		noun:f:v_naz 
смаку	                    noun:m:v_rod 
бельгійського	     		adj:n:v_rod 
пива	                    noun:n:v_rod 
надто       	            adv 
низька       	          	adj:f:v_naz:compb 
про	                        prep:rv_zna 
що	                        pron:int:rel:n:v_zna 
зробив	                  	verb:past:m:perf 
зауваження	           		noun:n:v_zna 
офіціанту	             	noun:m:v_dav:anim 
Звичайно     	         	adv:compb 
мене	                    pron:pers:s:1:v_rod:anim 
намагались	          		verb:rev:past:p:imperf 
переконати	         		verb:inf:perf 
в            	            prep:rv_mis:v-u 
іншому        	           	adj:m:v_mis:&pron:def 
але	                        conj:coord
нажаль      		         insert:bad 
вам	                        pron:pers:p:2:v_dav:anim 
є	                        verb:pres:p:2:imperf  
над	                        prep:rv_oru 
чим	                        pron:int:rel:n:v_oru 
працювати	        		verb:inf:imperf 
в	                        prep:rv_mis:v-u 
цьому	                    adj:m:v_mis:&pron:dem
напрямку	             	noun:m:v_mis
маю	                        verb:pres:s:1:imperf
підозру	                  	noun:f:v_zna 
що	                        conj:subord  
справа	                    noun:f:v_naz 
саме         	            part
в	                        prep:rv_mis:v-u 
персоналі	            	noun:m:v_mis 
Тому	                    conj:subord
будьте	                    verb:impr:p:3:imperf 
пильні       	            adj:p:v_naz:compb
А	                     	conj:coord
сам	                        adj:m:v_naz:&pron:def
заклад	                   	noun:m:v_naz
і	                        part 
справді	                  	adv 
досить       	           	adv  
хороший	                  	adj:m:v_naz:compb
За	                        prep:rv_rod
потреби      	         	noun:f:v_rod
можу         	           	verb:unknown 
вказати	                 	verb:inf:perf:v-u 
точний	                   	adj:m:v_zna:compb 
день	                    noun:m:v_zna 
та           	            conj:coord 
годину	                   	noun:f:v_zna 
відвідування 	     		noun:n:v_rod 
Відвідали	            	verb:past:p:perf 
заклад        	           	noun:m:v_zna 
в             	            prep:rv_mis:v-u 
рамках	                    noun:p:v_mis 
пивного	                   	adj:m:v_rod 
туру	                    noun:m:v_rod 
В	               			prep:rv_mis:v-u 
принципі	              	noun:m:v_mis 
антураж	                  	noun:m:v_naz
сподобався	          		verb:rev:past:m:perf 
меню	                    noun:n:v_naz:nv
вразило      	         	verb:past:n:perf 
своїм	                    adj:n:v_oru:&pron:pos 
різноманіттям	     		noun:n:v_oru 
єдиний	                   	adj:m:v_naz 
мінус	                    noun:m:v_naz
не	                        part 
все	                        adv:v-u (pron:pers:m:3:v_naz:anim)
з                           prep:rv_rod:rv_zna:rv_oru 
вказаного	             	adjp:pasv:past:m:v_rod:v-u
в            	            prep:rv_mis:v-u 
меню                        noun:n:v_mis:nv 
було        	            verb:past:n:imperf 
в	                        prep:rv_mis::v-u 
наявності	           	 	noun:f:v_mis 
а	                        conj:coord 
так          	            part 
в	                        prep:rv_mis:v-u 
принципі	              	noun:m:v_mis 
враження	             	noun:n:v_naz
залишились   	       		verb:rev:past:p:perf 
позитивні	          		adj:p:v_naz:compb
Непогано     	        	adv 
загалом	                  	adv
не	                        part 
кнопочок    	         	noun:p:v_rod 
виклику     	          	noun:m:v_rod 
офіціанта     	         	noun:m:v_rod:anim
як	                        adv:&pron:int:rel
в	                        prep:rv_mis:v-u 
наприклад	            	insert 
По	                        prep:rv_mis 
стейках	                    noun:p:v_mis 
якість      	           	noun:f:v_naz 
м'яса          	            noun:n:v_rod 
подача	                   	noun:f:v_naz 
хороші         	          	adj:p:v_naz:compb
Але	                        excl 
ступінь	                  	noun:m:v_naz 
прожарки	             	noun:f:v_rod:np:bad 
це	                     	adj:n:v_naz:&pron:dem(part)
крах        	            noun:m:v_naz  
замовив	               		verb:past:m:perf 
принесли	             	verb:past:p:perf 
якийсь	                  	adj:m:v_zna:&pron:ind 
Не	                        part 
солідно	                  	adv:compb 
цікаво	                  	adv:compb 
що	                        conj:subord  
принесуть      	         	verb:futr:p:3:perf 
коли	                    conj:subord
замовиш      	         	verb:futr:s:2:perf 
Салати	                   	noun:p:v_naz
цікаві	                 	adj:p:v_naz:compb 
інтер'єр	            	noun:m:v_naz 
доволі	                   	adv 
простенький    	    	 	adj:m:v_naz
Моя	                        adj:f:v_naz:&pron:pos 
оцінка	                 	noun:f:v_naz 
4	                        number 
Вже         	            adv:v-u 
вкотре	                   	adv:v-u 
розчаровуюсь	  			verb:rev:pres:s:1:imperf
Я	                        pron:pers:s:1:v_naz:anim 
вже	                        adv:v-u 
декілька	            	numr:p:v_naz:&pron:ind
років       	            noun:p:v_rod 
підряд        	           	noun:m:v_naz (adv) 
була	                    verb:past:f:imperf 
постійною	            	adj:f:v_oru 
клієнткою	            	noun:f:v_oru:anim 
даного       	            adjp:pasv:past:m:v_rod 
закладу	                   	noun:m:v_rod 
незважаючи	           		prep 
на	                        prep:rv_zna:rv_mis 
те           	            adj:n:v_zna:&pron:dem 
що	                        conj:subord 
мене         	            pron:pers:s:1:v_rod:anim 
з            	            prep:rv_oru 
батьками	               	noun:p:v_oru:anim 
стільки	                  	numr:p:v_zna:&pron:ind 
разів	                    noun:p:v_rod 
там	                        adv:&pron:dem 
нагло          	            adv 
на	                        prep:rv_mis 
стейках	                   	noun:p:v_mis 
приносячи    	       		advp:imperf 
якесь	                   	adj:n:v_zna:&pron:ind 
і           	            conj:coord 
круглу         	          	adj:f:v_zna 
в            	            prep:rv_mis:v-u 
чеку	                    noun:m:v_mis 
батьки	                   	noun:p:v_naz:anim 
перестали      	        	verb:past:p:perf 
ходити       	          	verb:inf:imperf 
та           	            conj:coord 
я             	            pron:pers:s:1:v_naz:anim 
все          	            part:v-u
ж              	            part 
постійно    	         	adv 
приходила	            	verb:past:f:imperf 
на	                        prep:rv_zna 
піцу	                    noun:f:v_zna 
кожного      	          	adj:m:v_rod:&pron:def
разу	                    noun:m:v_rod 
замовляла    	        	verb:past:f:imperf 
одну         	            numr:f:v_zna 
і            	            conj:coord 
ту           	            adj:f:v_zna:&pron:dem 
ж	                        part 
по            	            prep:rv_zna 
декілька	             	numr:p:v_zna:&pron:ind 
разів	                    noun:p:v_rod 
на           	            prep:rv_zna:rv_mis 
місяць	                   	noun:m:v_zna 
Кожного      	          	adj:m:v_rod:&pron:def 
разу	                    noun:m:v_rod 
я	                        pron:pers:s:1:v_naz:anim 
чекаю	                   	verb:pres:s:1:imperf 
чогось	                    pron:ind:n:v_rod
нового       	            adj:n:v_rod:compb 
то          	            conj:subord 
сік          	            noun:m:v_zna
не	                        part 
той          	            adj:m:v_zna:&pron:dem 
принесли     	       		verb:past:p:perf 
то	                        conj:subord 
не	                        part 
доклали	                 	verb:past:p:perf 
інгредієнти  	       		noun:p:v_naznoun:p:v_zna 
які         	            adj:p:v_naz:&pron:int:rel:def
замовлялися	          		verb:rev:past:p:imperf 
то	                        conj:subord 
взагалі	                  	adv:v-u 
піца	                    noun:f:v_naz 
не	                        part 
та	                     	conj:coord (pron:ind:s:v_naz:anim) 
Щоб	                        part 
колись         	           	adv:&pron:ind
вибачився	           		verb:rev:past:m:perf 
хтось	                   	pron:ind:v_naz:anim 
Ні	                        part 
жодного      	           	adj:m:v_rod:&pron
разу         	            noun:m:v_rod 
Але                         conj:coord 
сьогодні	             	adv 
це	                     	adj:n:v_naz:&pron:dem(part)
перейшло     	          	verb:past:n:perf 
всі	                        adj:p:v_zna:&pron:dem
межі         	            noun:p:v_zna 
Ми	                        pron:pers:p:1:v_naz:anim
з	                        prep:rv_oru
моїм          	            adj:m:v_oru:&pron:pos
хлопцем        	          	noun:m:v_oru:anim 
прийшли     	           	verb:past:p:perf 
о	                        prep:rv_zna:rv_mis 
16:30	                   	time 
замовили	             	verb:past:p:perf 
піцу	                    noun:f:v_zna 
велика	                	adj:f:v_naz:compb 
і	                        conj:coord 
з	                        prep:rv_oru
додатковою	            	adj:f:v_oru 
кукурудзою	             	noun:f:v_oru 
Близько      	           	adv:compb 
17	                        number 
прийшли	                    verb:past:p:perf 
ще	                        part 
якісь          	            adj:p:v_naz:&pron:ind 
клієнти	                    noun:p:v_naz:anim 
зробили      	           	verb:past:p:perf 
замовлення	            	noun:n:v_zna 
і           	            conj:coord 
їм	                        pron:pers:p:3:v_dav:anim
майже	                    adv  
одразу	                    adv 
принесли                	verb:past:p:perf 
їх           	            pron:pers:p:3:v_zna:anim
замовлення	            	noun:n:v_zna 
а            	            conj:coord 
нам          	            pron:pers:p:1:v_dav:anim
так          	            adv:&pron:dem
нічого        	            pron:neg:v_rod 
і                           conj:coord 
нема        	            predic 
хоч	                        part 
тарілки	                  	noun:p:v_zna 
принесли	              	verb:past:p:perf 
одразу	                    adv 
Піцу	                    noun:f:v_zna 
принесли	    		 	verb:past:p:perf 
нам                         pron:pers:p:1:v_dav:anim 
в	                        prep:rv_zna:rv_mis:rv_rod:v-u 
17:08	                    time 
Сиру	                    adj:f:v_zna 
не	                        part 
ту           	            adj:f:v_zna:&pron:dem 
яку	                       	adj:f:v_zna:&pron:int:rel:def
ми	                        pron:pers:p:1:v_naz:anim 
замовляли	             	verb:past:p:imperf 
та          	            conj:coord 
і	                        conj:coord
взагалі      	           	adv:v-u 
важко	                    adv:compb 
було	                    verb:past:n:imperf 
здогадатися	           		verb:rev:inf:perf 
що	                        conj:subord 
саме        	            part
це            	         	adj:n:v_naz:&pron:dem (part)
була	                    verb:past:f:imperf 
за           	            prep:rv_rod:rv_zna:rv_oru 
піца	                    noun:f:v_naz 
адже	                    conj:subord
начинки	                   	noun:f:v_rod
на          	            prep:rv_mis 
ній	                        pron:pers:f:3:v_mis:anim 
майже	                    adv 
не            	            part 
було                     	verb:past:n:imperf 
як	                        conj:subord 
і             	            conj:coord 
кукурудзи	             	noun:f:v_rod 
Піца	                    noun:f:v_naz 
була	                    verb:past:f:imperf 
ЦІЛКОМ	                    adv 
і            	            conj:coord 
ПОВНІСТЮ     	          	adv 
сирою        	            adj:f:v_oru 
Ми          	            pron:pers:p:1:v_naz:anim 
вирішили	              	verb:past:p:perf 
її	                        pron:pers:f:3:v_rod:anim 
спробувати	            	verb:inf:perf 
і            	            conj:coord 
таки        	            part 
вона	                    pron:pers:f:3:v_naz:anim 
була	                    verb:past:f:imperf 
сира	                    adj:f:v_naz 
від	                        prep:rv_rod 
чого	                    pron:int:rel:n:v_rod 
у	                        prep:rv_zna:rv_mis:rv_rod:v-u 
нас	                        pron:pers:p:1:v_rod:anim 
одразу       	          	adv 
животи	                  	noun:p:v_zna 
Піцу	                    noun:f:v_zna 
ми	                        pron:pers:p:1:v_naz:anim 
так         	            part 
і	                        conj:coord 
залишили	              	verb:past:p:perf 
і            	            conj:coord 
вирішили                 	verb:past:p:perf 
подзвонити	          		verb:inf:perf 
до	                        prep:rv_rod 
офіціантів	             	noun:p:v_rod:anim 
ми	                        pron:pers:p:1:v_naz:anim 
сиділи	                   	verb:past:p:imperf 
в	                        prep:rv_mis:v-u 
нижньому	               	adj:m:v_mis 
залі	                    noun:m:v_mis 
Подзвонили    	       		verb:past:p:perf 
ми	                        pron:pers:p:1:v_naz:anim 
близько	                 	adv:compb 
5	                        number 
разів	                    noun:p:v_rod 
З            	            prep:rv_oru 
перервою	              	noun:f:v_oru 
у	                        prep:rv_mis:v-u 
декілька	             	numr:p:v_zna:&pron:ind 
хвилин      	          	noun:p:v_rod 
Нарешті	                  	adv  
прийшла	                   	verb:past:f:perf 
привітна     	       		adj:f:v_naz:compb 
дівчинка	             	noun:f:v_naz:anim 
і	                        conj:coord 
якщо	                    conj:subord 
чесно	                   	adv:compb 
то	                        conj:subord 
не	                        part 
хотілося	             	verb:unknown 
саме	                    part 
їй           	            pron:pers:f:3:v_dav:anim 
псувати       	          	verb:inf:imperf 
настрій     	          	noun:m:v_zna 
і	                        conj:coord 
підставляти	         		verb:inf:imperf 
її                          pron:pers:f:3:v_zna:anim 
адже	                    conj:subord
замовлення	          		noun:n:v_zna 
брала	                  	verb:past:f:imperf 
у	                        prep:rv_rod:v-u 
нас	                        pron:pers:p:1:v_rod:anim
не            	            part 
вона	                    pron:pers:f:3:v_naz:anim 
Ваше	                    adj:n:v_naz:&pron:pos (pron:rel:p:1:v_rod:anim)
приходьте      	        	verb:impr:p:2:imperf 
ще	                        part 
і	                        conj:coord 
миле	                   	adj:n:v_zna:compb 
Гарного	                   	adj:m:v_rod:compb 
дня	                        noun:m:v_rod 
можете        	            verb:unknown 
засунути	           		verb:inf:perf 
собі          	            pron:refl:m:v_dav
в              	            prep:rv_zna:v-u 
одне	                    numr:n:v_zna 
місце         	           	noun:n:v_zna 
Не	                        part 
думаю	                  	verb:pres:s:1:imperf 
що	                      	conj:subord
ще           	            part 
хоч                     	part 
колись              		adv:&pron:ind 
захочу	                 	verb:unknown 
до	            			prep:rv_rod 
Вас	                        pron:pers:p:2:v_rod:anim
прийти	                	verb:inf:perf 
думаю	                  	verb:pres:s:1:imperf 
пора	                    noun:f:v_naz 
викидати	             	verb:inf:imperf 
картку	                   	noun:f:v_zna 
постійного	           	 	adj:m:v_rod
клієнта     	          	noun:m:v_rod:anim
вашого	                    adj:m:v_rod:&pron:pos 
закладу	                  	noun:m:v_rod 
Як	                        adv:&pron:int:rel
ви            				pron:pers:p:2:v_naz:anim
там           	            part 
кажете	                   	verb:pres:p:2:imperf 
Гарного	                   	adj:m:v_rod:compb 
Вам           	            pron:pers:p:2:v_dav:anim
дня	                        noun:m:v_rod 
Доброго	                   	adj:m:v_rod:compb
дня	                        noun:m:v_rod 
друзі	                    noun:p:v_kly:anim
Сьогодні	             	adv 
в	                        prep:rv_zna:v-u 
який         	            adj:m:v_zna:&pron:int:rel:def
раз	                        noun:m:v_zna 
зателефонувала	   			verb:past:f:perf 
дівчатам	      			noun:p:v_dav:anim 
щоб                     	conj:subord
замовити	             	verb:inf:perf 
столик	                  	noun:m:v_zna 
щоп'ятниці	           		adv 
по	                        prep:rv_mis:rv_zna (prep:rv_dav)
можливості	           		noun:f:v_dav
відвідую	          		verb:pres:s:1:imperf 
даний	                  	adjp:pasv:past:m:v_zna 
заклад	                  	noun:m:v_zna 
і	                        conj:coord 
випадково	            	adv 
прочитала	            	verb:past:f:perf 
відгуки	                   	noun:p:v_zna 
я             	            pron:pers:s:1:v_naz:anim 
вражена	               		adjp:pasv:past:f:v_naz 
негативом	             	noun:m:v_oru 
від	                        prep:rv_rod 
декількох	            	numr:p:v_rod:&pron:ind
відвідувачів	       		noun:p:v_rod:anim 
я	                        pron:pers:s:1:v_naz:anim 
не	                        part 
сперечаюсь	        		verb:rev:pres:s:1:imperf 
що	                        conj:subord 
кожен	                	adj:m:v_naz:contr 
може	                   	verb:unknown 
висловити	           		verb:inf:perf 
своє	                    adj:n:v_naz:&pron:pos (pron:pos:s:1:v_naz:anim)
думку	                   	noun:f:v_zna 
та	                        conj:coord 
враження	            	noun:n:v_zna 
але	                        conj:coord 
давайте	                  	verb:impr:p:2:imperf 
оцінювати	          		verb:inf:imperf 
тверезо	                	adv:compb 
і	                        conj:coord 
з	                        prep:rv_rod:rv_zna:rv_oru
позитивом	            	noun:m:v_oru 
Заклад	                  	noun:m:v_naz 
затишний	            	adj:m:v_naz:compb 
кухня	                  	noun:f:v_naz 
неперевершена	  			adj:f:v_naz:&adjp:pasv:past 
обслуговування	  			noun:n:v_naz 
хороше	            	   	adj:n:v_naz:compb 
а	                       	conj:coord 
музика	                 	noun:f:v_naz  
Барви	                 	noun:p:v_naz
Блюзу	                	noun:m:v_rod 
драйвова	           		adj:f:v_naz:slang 
і	                        conj:coord 
для	                        prep:rv_rod 
душі	                    noun:f:v_rod 
дорого	                  	adv:compb 
не	                        part 
підходить	          		verb:pres:s:3:imperf 
ідіть	                    verb:impr:p:2:imperf 
в	                        prep:rv_zna:v-u 
генделик	        		noun:m:v_zna 
Я	                        pron:pers:s:1:v_naz:anim 
вважаю        	         	verb:pres:s:1:imperf 
що                          conj:subord  
такі         	           	adj:p:v_zna:&pron:def 
відгуки      	          	noun:p:v_zna 
знаючи	                   	advp:imperf 
даний	                   	adjp:pasv:past:m:v_zna 
заклад	                  	noun:m:v_zna 
залишають	            	verb:pres:p:3:imperf 
люди	                    noun:p:v_naz:anim 
які	                        adj:p:v_naz:&pron:int:rel:def (conj:subord)
самі        	            adj:p:v_naz:&pron:def
в            	            prep:rv_mis:v-u 
житі	                    noun:n:v_mis 
нічого	                    pron:neg:v_rod 
не	                        part 
реалізовані	        		adjp:pasv:past:p:v_zna 
і	                        conj:coord 
не          	            part 
зовсім	                 	adv 
чітко	                   	adv:compb 
розуміють	           		verb:pres:p:3:imperf 
як	                        conj:subord
важко         	           	adv:compb 
працюють    	       		verb:pres:p:3:imperf 
всі	                        adj:p:v_naz:&pron:dem 
працівники    	       		noun:p:v_naz:anim 
закладу	                  	noun:m:v_rod  
Дякую	                	verb:pres:s:1:imperf 
всім	                    adj:p:v_dav:&pron:dem 
тим	                        adj:p:v_dav:&pron:dem 
хто	                        pron:int:rel:m:v_naz:anim
працює	        			verb:pres:s:3:imperf 
для         	            prep:rv_rod 
нас	                        pron:pers:p:1:v_rod:anim
за	                        prep:rv_rod:rv_zna:rv_oru
нас	                        pron:pers:p:1:v_rod:anim
і	                        conj:coord 
заради	             	    prep:rv_rod 
нашого	                    adj:m:v_rod:&pron:pos 
відпочинку	         		noun:m:v_rod 
а	                        conj:coord 
директору	           		noun:m:v_dav:anim 
бажаю	                  	verb:pres:s:1:imperf 
менше        	           	adv:compr 
а	                        conj:coord
краще	         			adj:n:v_naz:compr (adv)
взагалі      	        	adv:v-u 
не	                        part 
звертати    	        	verb:inf:imperf 
увагу                 		noun:f:v_zna 
на	                        prep:rv_zna 
ці	                     	adj:p:v_zna:&pron:dem 
відгуки	                 	noun:p:v_zna 
З	                        prep:rv_oru
найкращими	            	adj:p:v_oru:super 
побажаннями	         	  	noun:p:v_oru 
з	                        prep:rv_oru
повагою	                  	noun:f:v_oru 
Олена	                  	noun:f:v_naz:anim:fname
Ціни	                    noun:p:v_naz 
зараз	                    adv:&pron:dem
фантастично	         	 	adv:compb 
дорогі	                  	adj:p:v_naz:compb 
За	                        prep:rv_zna
4	                        number 
стейки	                   	noun:p:v_zna 
2	                        number 
картоплі	           	 	noun:f:v_rod 
та	                        conj:coord 
2	                        number 
порції	                 	noun:p:v_zna 
овочів                      noun:p:v_rod 
та	                        conj:coord
2	                        number 
пива	                    noun:p:v_zna 
заплатили	            	verb:past:p:perf 
800	                        number 
гривен	                   	noun:p:v_rod 
декілька	             	numr:p:v_zna:&pron:ind 
місяців                    	noun:p:v_rod 
перед	                  	noun:m:v_naz (prep:rv_oru) 
тим	                        adj:m:v_oru:&pron:dem 
за                          prep:rv_zna
те	                        adj:n:v_zna:&pron:dem 
саме         	            part
заплатили    	        	verb:past:p:perf 
480	                        number 
гривен	                   	noun:p:v_rod 
напевно	                  	adv 
привозять	            	verb:pres:p:3:imperf 
чартерним	            	adj:m:v_oru
рейсом	                    noun:m:v_oru 
з	                        prep:rv_rod
Уругваю	                	noun:m:v_rod 
за          	            prep:rv_zna
таку	                    adj:f:v_zna:&pron:def 
ціну	                   	noun:f:v_zna 
Більше	         			adv:compr 
не	                        part 
підемо	                   	verb:futr:p:1:perf 
Дуже	              	    adv 
сподобався	          		verb:rev:past:m:perf 
стейк	                    noun:m:v_naz 
Шатобріан	         		noun:m:v_naz:anim:lname 
особливо	          	 	adv 
в	                        prep:rv_mis:v-u 
поєднанні	           	 	noun:n:v_mis 
з	                        prep:rv_oru 
салатом	                    noun:m:v_oru 
Лас-Вегас    	       		noun:m:v_naz 
смак	                    noun:m:v_naz 
салату                  	noun:m:v_rod
я	                        pron:pers:s:1:v_naz:anim 
згадую	                	verb:pres:s:1:imperf 
й	                        conj:coord 
досі	                    adv:&pron:dem
А	                        part 
от           	            part 
на	                        prep:rv_mis 
кістці	                	noun:f:v_mis 
чоловіку	              	noun:m:v_dav:anim 
не	                        part 
сподобався	          		verb:rev:past:m:perf 
замало      	           	adv 
і	                        conj:coord 
сирувате	         		adj:n:v_naz 
І	                        conj:coord 
ще	                        part 
в	                        prep:rv_mis:v-u 
закладі	                   	noun:m:v_mis 
стоїть	                  	verb:pres:s:3:imperf 
якийсь	                  	adj:m:v_naz:&pron:ind
неприємний   	      		adj:m:v_naz:compb 
запах        	          	noun:m:v_naz  
плісняви	             	noun:f:v_rod 
це	                    	adj:n:v_naz:&pron:dem  (part)
дуже	                    adv
псує        	          	verb:pres:s:3:imperf 
враження	            	noun:n:v_zna 
прямо	                   	adv:compb 
з	                        prep:rv_rod
порогу	                    noun:m:v_dav ( noun:m:v_rod)
Вибирав	                  	verb:past:m:imperf 
куди	                    adv:&pron:int:rel 
піти	                    verb:inf:perf
відсвяткувати	     		verb:inf:perf 
своє	                    adj:n:v_naz:&pron:pos (pron:refl:v_naz)
із	                        prep:rv_oru
друзями	                    noun:p:v_oru:anim 
Про	                        prep:rv_zna 
гриль	                    noun:m:v_zna 
чув	                        verb:past:m:imperf 
схвальні	            	adj:p:v_zna 
відгуки	                    noun:p:v_zna 
від	                        prep:rv_rod 
знайомих	              	noun:p:v_rod:anim 
і                           conj:coord 
сам         	            adj:m:v_naz:&pron:def (pron:refl:v_naz)
там	                        adv:&pron:dem
один         	            numr:m:v_zna 
раз	                        noun:m:v_zna 
побував	                  	verb:past:m:perf 
можу	                    verb:unknown 
сказати	                   	verb:inf:perf 
що	                        conj:subord 
все	                        adv:v-u (pron:def:v_naz)
було          	            verb:past:n:imperf 
на	                        prep:rv_mis 
пристойному	            	adj:m:v_mis 
рівні	                    noun:m:v_mis
і              	            conj:coord 
щодо          	            prep:rv_rod 
кухні	                    noun:f:v_rod 
також         	            adv 
Але	                        conj:coord
прочитавши   	         	advp:perf 
коментарі	             	noun:p:v_zna 
залишені	             	adjp:pasv:past:p:v_zna 
на	                        prep:rv_mis 
цьому	        			adj:m:v_mis:&pron:dem
ресурсі	                   	noun:m:v_mis 
поміняв	                  	verb:past:m:perf 
свою	                    adj:f:v_zna:&pron:pos (pron:refl:v_naz)
точку	                    noun:f:v_zna
зору         	            noun:m:v_rod 
Чому	                    adv:&pron:int:rel 
Пояснюю	                	verb:pres:s:1:imperf 
Це	                      	adj:n:v_naz:&pron:dem (part)
стосується   	       		verb:rev:pres:s:3:imperf 
тих	                        adj:p:v_rod:&pron:dem 
дописувачів   	         	noun:p:v_rod:anim 
Олександр	            	noun:m:v_naz:anim:fname 
які	                        adj:p:v_naz:&pron:int:rel:def
вступають    	          	verb:pres:p:3:imperf 
в	                        prep:rv_zna:v-u 
дискусію	              	noun:f:v_zna 
від	                        prep:rv_rod 
імені	                    noun:n:v_rod 
чи	                        conj:coord:subord
то                          conj:subord 
працівників  	         	noun:p:v_rod:anim 
цього	                    adj:m:v_rod:&pron:dem
закладу     	            noun:m:v_rod
чи	                        conj:coord:subord 
то	                        conj:subord 
власників	               	noun:p:v_rod:anim 
Шановні	                  	adj:p:v_naz (noun:m:v_kly)
майте	                    verb:impr:p:2:imperf
хоч	                        part 
трошки      	            adv 
ввічливості  	       		noun:f:v_rod:v-u 
до	                        prep:rv_rod 
своїх	                    adj:p:v_mis:&pron:pos (pron:refl:v_rod:anim)
минулих     	           	adjp:actv:past:p:v_rod 
майбутніх    	      		adj:p:v_rod 
і            	            conj:coord 
теперішніх     	        	adj:p:v_rod 
відвідувачів	        	noun:p:v_rod:anim 
Якщо	                    conj:subord 
комусь	                    pron:ind:v_dav:anim 
і                           conj:coord 
не	                        part 
сподобалася	           		verb:rev:past:f:perf 
Ваша	                    adj:f:v_naz:&pron:pos 
сира	                    adj:f:v_naz 
риба	                    noun:f:v_naz:anim 
чи	                        conj:coord:subord 
погане	                  	adj:n:v_naz:compb 
обслуговування	   		 	noun:n:v_naz
то	                        conj:subord 
вибачтесь	            	verb:rev:impr:p:2:perf 
перед	                    noun:m:v_naz (prep:rv_oru)
цим	                        adj:m:v_oru:&pron:dem
відвідувачем	        	noun:m:v_oru:anim 
який	                    adj:m:v_naz:&pron:int:rel:def (conj:subord)
заплатив     	         	verb:past:m:perf 
Вам	                        pron:pers:p:2:v_dav:anim 
гроші	                    noun:p:v_zna 
запросіть	             	verb:impr:p:2:perf 
його           	            pron:pers:m:3:v_zna:anim
прийти         	          	verb:inf:perf 
до	                        prep:rv_rod 
Вас	                        pron:pers:p:2:v_rod:anim 
ще	                        part 
раз            	            noun:m:v_zna 
щоб                         conj:subord 
переконатися	      		verb:rev:inf:perf 
що           	            conj:subord 
у              	            prep:rv_rod:v-u 
Вас           	            pron:pers:p:2:v_rod:anim
більше                      adv:compr 
такого	                    adj:m:v_rod:&pron:def 
не	                        part 
повториться 	       		verb:rev:futr:s:3:perf 
а	                        conj:coord 
не           	            part 
вступати	             	verb:inf:imperf 
у	                        prep:rv_zna:v-u 
недопустиму	          		adj:f:v_zna 
манеру	                    noun:f:v_zna 
спілкування	           		noun:n:v_rod 
з            	            prep:rv_rod 
Вашого	                    adj:m:v_rod:&pron:pos 
боку         	            noun:m:v_rod 
Панове	                    noun:p:v_kly:anim 
так	                        adv:&pron:dem
негарно                    	adv 
Ви	                        pron:pers:p:2:v_naz:anim
псуєте	                   	verb:pres:p:2:imperf 
собі	                    pron:refl:m:v_dav 
репутацію	             	noun:f:v_zna 
виставляючи   	       		advp:imperf 
себе	                    pron:refl:m:v_zna
грубими	                    adj:p:v_oru:compb 
і	                        conj:coord 
неадекватними	      		adj:p:v_oru 
людьми	                    noun:p:v_oru:anim 
по	                        prep:rv_mis:rv_zna ( prep:rv_dav)
відношенню	           		noun:n:v_dav 
до             	            prep:rv_rod 
своїх	                    adj:p:v_mis:&pron:pos (pron:pos:m:v_rod)
клієнтів    	            noun:p:v_rod:anim 
Дякую	                  	verb:pres:s:1:imperf 
Була	                    verb:past:f:imperf 
на	                        prep:rv_mis 
вихідних	               	adj:p:v_mis
з                           prep:rv_oru
друзями	                    noun:p:v_oru:anim 
з	                        prep:rv_rod
Москви	                  	noun:f:v_rod 
так	                        conj:coord:subord
як                          conj:subord
компанія	               	noun:f:v_naz 
була         	            verb:past:f:imperf 
досить	                    adv  
велика	                    adj:f:v_naz:compb 
замовляли	              	verb:past:p:imperf 
всього       	         	adj:m:v_rod:&pron:dem (pron:def:rel:n:v_rod)
і	                        conj:coord 
багато        	            adv  
Стейки	                    noun:p:v_naz 
вище         	            adv:compr:compr 
будь-яких	            	adj:p:v_rod:&pron:ind 
похвал	                   	noun:p:v_rod 
настільки	             	adv 
класне	                 	adj:n:v_naz 
м'ясо                       noun:n:v_naz 	
що	                        conj:subord 
ми           	            pron:pers:p:1:v_naz:anim
взяли	                   	verb:past:p:perf 
з	                        prep:rv_oru
собою	                    pron:refl:m:v_oru 
Ковбой                      noun:m:v_naz:anim 
на	                        prep:rv_mis 
вході	                    noun:m:v_mis 
дуже        	            adv  
харизматичний	      		adj:m:v_naz 
дядько	                    noun:m:v_naz:anim 
Дуже	                    adv  
приємно	                   	adv:compb 
що	                        conj:subord 
є	                        verb:pres:s::imperf 
таке         	            adj:n:v_naz:&pron:def 
місце         	            noun:n:v_naz 
де            	            adv:&pron:int:rel (conj:subord) 
знають        	            verb:pres:p:3:imperf 
толк	                    noun:m:v_zna 
в	                        prep:rv_mis:v-u 
стейках      	            noun:p:v_mis 
та           	            conj:coord 
закусках     	            noun:p:v_mis 
Шкода	                   	noun:f:v_naz 
не	                        part 
маю                        	verb:pres:s:1:imperf
можливості	             	noun:f:v_rod 
частіше	                    adv:compr 
бувати	                    verb:inf:imperf 
у	                        prep:rv_mis:v-u 
Львові	                    noun:m:v_mis 
Але                        	conj:coord 
тепер	                    adv:&pron:dem 
точно	                    adv 
знаю	                    verb:pres:s:1:imperf 
куди	                   	adv:&pron:int:rel 
вести	                    verb:inf:imperf 
гостей	                   	noun:p:v_zna:anim 
нашого	                    adj:n:v_rod:&pron:pos 
міста                      	noun:n:v_rod 
Успіхів	                    noun:p:v_rod 
та	                        conj:coord 
процвітання	           		noun:n:v_rod