Ju1 20-30 female
не	не                              part  0
закриваються	закриватися         verb:rev:pres:p:3:imperf  0
самі	сам,самий                   pron:def   0
проблема	проблема                noun:f:v_naz  0
виключно	виключно                adv  0
людей	люди                        noun:p:v_rod:anim   0
які	який                            pron:int:rel:def 0
готували	готувати                verb:past:p:imperf  0
заклад	заклад                      noun:m:v_zna  0
до	до                              prep:rv_rod  0
відкриття	відкриття               noun:n:v_rod   0
Ресторан	ресторан                noun:m:v_naz  20
яким	який                        pron:def 0
ЯПІ	-                               noun 0
вважається	вважатися               verb:rev:pres:s:3:imperf  0
це	цей                             pron:dem   0
особливий	особливий               adj:m:v_naz  10
тип	тип                             noun:m:v_naz   10
підприємства	підприємство        noun:n:v_rod  20
у	у                               prep:v-u  0
якому	який                        pron:def  0
організація	організація             noun:f:v_naz  10
виробництва	виробництво             noun:n:v_rod  0
різноманітного	різноманітний       adj:m:v_rod:compb  10
асортименту	асортимент              noun:m:v_rod  0
кулінарної	кулінарний              adj:f:v_rod  10
продукції	продукція               noun:f:v_rod  10
складного	складний                adj:m:v_rod:compb  0
готування	готування               noun:n:v_rod   0
поєднується	поєднуватися            verb:rev:pres:s:3:imperf  10
з	з                               prep:rv_oru  0
організацією	організація         noun:f:v_oru  0
високого	високий                 adj:m:v_rod:compb  20
рівнярівень                         noun:m:v_rod  20
обслуговування	обслуговування      noun:n:v_rod   20
відвідувачів	відвідувач          noun:p:v_zna:anim  20
у	у                               prep:v-u  0
торгових	торговий                adj:p:v_mis  0
залах зал                           noun:p:v_mis  0
ресторану	ресторан                noun:m:v_rod  0
А	а                               conj:coord  0
сервіс	сервіс                      noun:m:v_naz  0
починається	починатися              verb:rev:pres:s:3:imperf  0
з	з                               prep:rv_oru 0
входу	вхід                        noun:m:v_rod  0
Додати	додати                      verb:inf:perf  0
більше великий                      adv:compr  0
нічого	ніщо                        predic   0
Просто	просто                      adv:compb  0
жахливий	жахливий                adj:m:v_naz:compb  0
заклад	заклад                      noun:m:v_naz   10
Гроші	гроші                       noun:p:v_naz  10
лишаєш	лишати                      verb:pres:s:2:imperf  10
великі	великий                     adj:p:v_naz:compb  0
обслуга	обслуга                     noun:f:v_naz  0
абсолютно	абсолютно               adv  0
ворожо                              adv -20
хамовито	                        adv -20
кухня	кухня                       noun:f:v_naz  -20
на	на                              prep:rv_zna 0
радянську	радянський              adj:f:v_zna  -20
не	не                              part  -20
тягне	тягнути, тягти              verb:pres:s:3:imperf  -20
Люди люди                           noun:p:v_naz:anim  0
не	не                              part  0
ідіть	іти                         verb:impr:p:2:imperf  0
і	і                               conj:coord   0
не	не                              part  0
підтримуйте	підтримувати            verb:impr:p:2:imperf  0
закладів	заклад                  noun:p:v_rod  0
подібного	подібний                adj:m:v_rod   0
типу	тип                         noun:m:v_rod   0
а	а                               conj:coord  0
керівництву	керівництво             noun:n:v_dav  0
порада	порада                      noun:f:v_naz  0
якщо	якщо                        conj:subord  0
хочете	хотіти                      verb:unknown  0
нормально	нормально               adv  0
працювати	працювати               verb:inf:imperf  0
дивіться	дивитися                verb:rev:impr:p:2:imperf  0
уважно	уважно                      adv:compb  20
кого	хто                         pron:int:m:v_rod:anim 20
ви	ви                              pron:pers:p:2:v_naz:anim 0
наймаєте	наймати                 verb:pres:p:2:imperf  0
на	на                              prep:rv_mis  0
роботу робота                       noun:m:v_mis:anim   0
Це	цей                             pron:dem  0
факт	факт                        noun:m:v_naz  10
я	я                               pron:pers:s:1:v_naz:anim  0
теж	теж                             adv  0
була бути                           verb:past:f:imperf  0
в	в                               prep:rv_mis:v-u  0
шоці	шок                         noun:m:v_mis  0
від	від                             prep:rv_rod  0
відвідування	відвідування        noun:n:v_rod  0
вперше	вперше                      adv:v-u  0
цього	цей                         pron:dem  0
закладу	заклад                      noun:m:v_rod  0
хоча	хоча                        conj:subord  0
чула чути                           adj:f:v_naz  0
негатив	негатив                     noun:m:v_naz  0
стосовно	стосовно                adv  0
цього	цей                         pron:dem  0
закладу	заклад                      noun:m:v_rod  0
попередньо	попередньо              adv   0
зокрема	зокрема                     adv  0
про	про                             prep:rv_zna  0
брудне	брудний                     adj:n:v_zna:compb  -20
хамське	хамський                    adj:n:v_zna  -20
ставлення	ставлення               noun:n:v_zna  -20
жіночки	жіночка                     noun:f:v_rod:anim  -20
на	на                              prep:rv_mis  -20
вході	вхід                        noun:m:v_mis  -20
яка	який                            pron:def  -20
може	могти                       verb:unknown  -20
дозволити	дозволити               verb:inf:perf  -20
собі	себе просто	просто          adv:compb  -20
обізвати	обізвати                verb:inf:perf  -20
лайкою	лайка                       noun:f:v_oru  -20
любого	любий                       noun:m:v_zna:anim  -20
і	і                               conj:coord  0
про	про                             prep:rv_zna  0
охорону	охорона                     noun:f:v_zna  0
яка який                            pron:int:rel:def  0
некерована	некерований             adj:f:v_naz  -10
відчула	відчути                     verb:past:f:perf  0
це	цей                             pron:dem  0
все	весь                            adv:v-u  0
на	на                              prep:rv_mis  0
ОГИДА                               noun:v-naz -30
більш	багато                      adv:compr  0
нічого ніщо                         pron:neg:v_rod  0
не	не                              part  0
залишилось	залишитися              verb:rev:past:n:perf  0
обізвали	обізвати                verb:past:p:perf  0
мене	я                           pron:pers:s:1:v_zna:anim  0
після	після                       adv  0
як	як                              adv: 0
я	я                               pron:pers:s:1:v_naz:anim  0
запропонувала	запропонувати       verb:past:f:perf  0
свою	свій                        adj:f:v_zna 0
курточку	курточка                noun:f:v_zna  0
яка	який                            pron:int  0
тоненька	тоненький               adj:f:v_naz  0
покласти	покласти                verb:inf:perf  0
у	у                               prep:rv_mis:v-u  0
мою	мій                             pron:pos  0
сумочку	сумочка                     noun:f:v_zna  0
щоб	щоб                             conj:subord  0
не	не                              part  0
здавати	здавати                     verb:inf:imperf  0
у	у                               prep:rv_zna:v-u  0
гардероб	гардероб                noun:m:v_naz  0
оскільки	оскільки                conj:subord  0
відчувала	відчувати               verb:past:f:imperf  0
прохолоду	прохолода               noun:f:v_zna  -10
на	на                              prep:rv_mis  -10
що	що                              conj:subord  0
звідси	звідси                      adv  0
забирайся	забиратися              verb:rev:impr:s:2:imperf  -20
я	я                               pron:pers:s:1:v_naz:anim  -20
була бути                           verb:past:f:imperf  0
шокована	шокований               adjp:pasv:past:f:v_naz  -10
Ще	ще                              adv  0
більше	багато                      adv:compr  0
була бути                           verb:past:f:imperf  0
шокована	шокований               adjp:pasv:past:f:v_naz  -10
від	від                             prep:rv_rod  -10
приватна	приватний               adj:f:v_naz  0
власність	власність               noun:f:v_zna  0
і	і                               conj:coord  0
маємо	мати                        verb:pres:p:1:imperf  0
право	право                       noun:n:v_zna  0
робити	робити                      verb:inf:imperf  0
що	що                              conj:subord  0
хочемо	хотіти                      verb:unknown  0
і	і                               conj:coord  0
впускати	впускати                verb:inf:imperf:v-u  0
тих	той                             pron:dem   0
хто	хто                             pron:int:anim 0
нам	ми                              pron:pers:p:1:v_dav:anim  0
подобається	подобатися              verb:rev:pres:s:3:imperf  0
а	а                               conj:coord  0
хто	хто                             pron:int:anim  0
можемо	могти                       verb:unknown  0
викидати	викидати                verb:inf:imperf  -20
геть	геть                        adv  -20
зараз	зараз                       adv  -20
скажемо	сказати                     verb:futr:p:1:perf  -20
що	що                              conj:subord   -20
була бути                           verb:past:f:imperf  -20
в	в                               prep:v-u  -20
нетверезому	нетверезий              adj:m:v_mis  -20
стані	стан                        noun:m:v_mis  -20
і	і                               conj:coord  -20
ми	ми                              pron:pers:p:1:v_naz:anim  -20
вирішили	вирішити                verb:past:p:perf  -20
хоча	хоча                        conj:subord  0
це	цей                             pron:dem  0
було	бути                        verb:past:n:imperf  0
не	не                              part  0
так	так                             adv  0
і	і                               conj:coord  0
ти	ти                              pron:pers:s:2:v_naz:anim  0
нічого	нічого                      predic  0
нікому	ніхто                       pron:neg:v_dav:anim  0
недокажеш	недоказати              verb:futr:s:2:perf  -20
Я	я                               pron:pers:s:1:v_naz:anim 0
ще	ще                              adv  0
такого	такий                       pron:def  0
хамства	хамство                     noun:n:v_rod  0
ніде	ніде                        adv 0
невже	невже                       part  0
дирекція	дирекція                noun:f:v_naz  0
клубу	клуб                        noun:m:v_rod  0
незацікавлена	незацікавлений      adj:f:v_naz  0
щоб	щоб                             conj:subord  0
був	бути                            verb:past:m:imperf  0
позитив	позитив                     noun:m:v_zna   0
щоб	щоб                             conj:subord  0
хотілось	хотітися                verb:unknown  0
туди	туди                        adv 0
приходити	приходити               verb:inf:imperf  0
тепер	тепер                       adv 0
я	я                               pron:pers:s:1:v_naz:anim 0
розумію	розуміти                    verb:pres:s:1:imperf  0
реакцію	реакція                     noun:f:v_zna  0
багатьох	багато                  numr:p:v_zna 0
моїх	мій                         adj:p:v_rod 0
Хоча	хоча                        conj:subord  0
персоналу	персонал                noun:m:v_dav  10
пофіг	-                           sleng 0
скільки	скільки                     numr:p:v_zna 0
клієнтів	клієнт                  noun:p:v_zna:anim  0
їм вони                             pron:pers:p:3:v_dav:anim  10
тим	той                             pron:dem   0
краще	хороший                     adj:n:v_naz:compr  0
а	а                               conj:coord  0
власник	власник                     noun:m:v_naz:anim  0
там	там                             adv 0
як	як                              adv 0
виявилося	виявитися               verb:rev:past:n:perf  0
сам	сам                             pron:def  0
грузин	грузин                      noun:m:v_naz:anim  0
чи	чи                              conj:subord  0
але	але                             conj:coord  0
живе жити                           verb:pres:s:3:imperf  0
у	у                               prep:rv_mis:v-u  0
Росії	Росія                       noun:f:v_mis  0
РОСІЙСЬКИЙ	російський              adj:m:v_naz  -20
ОЛІГАРХ	олігарх                     noun:m:v_naz:anim  -20
якому	який                        pron:rel -20
до	до                              prep:rv_rod  -20
одного	один                        numr:n:v_rod  0
місця	місце                       noun:n:v_rod  0
що	що                              conj:subord  0
з	з                               prep:rv_oru  0
тими	той                         pron:dem  0
українцями	українець               noun:p:v_oru:anim  0
робить	робити                      verb:pres:s:3:imperf  0
його він                            pron:pos  0
персонал	персонал                noun:m:v_zna  0
чи	чи                              conj:subord  0
він	він                             pron:pers:m:3:v_naz:anim  0
їх	вони                            pron:pers:p:3:v_rod:anim  0
викидає	викидати                    verb:pres:s:3:imperf  0
при	при                             prep:rv_mis  0
цьому	цей                         pron:dem  0
обдираючи	обдирати                adv:p:imperf  0
руки	рука                        noun:p:v_zna  0
дор	-                               bad 0
крові	кров                        noun:f:v_rod   0
чи	чи                              conj:subord  0
просто	просто                      adv:compb   0
б'є	бити                            verb:pres:s:3:imperf  0
я	я                               pron:pers:s:1:v_naz:anim  0
думаю	думати                      verb:pres:s:1:imperf  20
йому	він                         pron:pers:m:3:v_dav:anim  0
це	цей                             pron:dem  0
навіть	навіть                      part  0
до	до                              prep:rv_rod  0
вподоби	вподоба                     noun:f:v_rod:v-u  0
Так	так                             adv  0
що	що                              conj:subord  0
якщо	якщо                        conj:subord  0
не	не                              part  0
хочете	хотіти                      verb:unknown  10
бути	бути                        verb:inf:imperf  10
принижені	принижений              adjp:pasv:past:p:v_naz   10
ображені	ображений               adjp:pasv:past:p:v_naz   -30
і	і                               conj:coord   -30
не	не                              part  0
виключення	виключення              noun:n:v_naz  -10
побиті побитий                      adjp:pasv:past:p:v_naz  -10
тільки	тільки                      adv  -10
тому	тому                        adv  -10
що	що                              conj:subord  -10
ви	ви                              pron:pers:p:2:v_naz:anim  0
жіночці	жіночка                     noun:f:v_dav:anim  -10
на	на                              prep:rv_mis  -10
вході	вхід                        noun:m:v_mis  0
яка	який                            nounon:def 0
дуууже	                            adj:f:v_naz:compb  0
і	і                               conj:coord  0
здається	здаватися               verb:rev:pres:s:3:imperf  0
дуже	дуже                        adv  0
незадоволена	незадоволений       adj:f:v_naz  0
життя	життя                       bad  0
вибирайте	вибирати                verb:impr:p:2:imperf  0
інше	інший                       adj:n:v_zna 0
місце	місце                       noun:n:v_zna  0
відпочинку	відпочинок              noun:m:v_rod  0
Здав	здати                       verb:past:m:perf  0
позиції	позиція                     noun:p:v_zna  0
цей	цей                             pron:dem 0
клуб	клуб                        noun:m:v_naz  0
давно	давно                       adv   0
За	за                              prep  0
такі	такий                       adj:p:v_naz 0
гроші	гроші                       noun:p:v_zna  0
які	який                            pron:int 0
платяться	платитися               verb:rev:pres:p:3:imperf  0
за	за                              prep:rv_zna 0
вхід	вхід                        noun:m:v_zna  0
можна	можна                       predic  0
було	бути                        verb:past:n:imperf  0
б	б                               part  0
і	і                               conj:coord   0
кондиціонування	кондиціонування     noun:n:v_zna  -20
зробити	зробити                     verb:inf:perf  0
і	і                               conj:coord   0
дивани	диван                       noun:p:v_naz 0
пропалені	пропалений              adjp:pasv:past:p:v_naz  0
замінити	замінити                verb:inf:perf   0
В	в                               prep:rv_mis:v-u  0
середині	середина                noun:f:v_mis  0
приміщення	приміщення              noun:n:v_zna   0
настільки	настільки               adv  0
накурено	накурити                verb:impers:perf  -10
що	що                              conj:subord   -10
декількох	декількох               numr:p:v_rod 0
хвилин	хвилина                     noun:p:v_rod  0
вистачає	вистачати               verb:pres:s:3:imperf  0
щоб	щоб                             conj:subord  0
весь	весь                        pron:dem  0
одяг	одяг                        noun:m:v_naz  0
проник	проникнути                  verb:past:m:perf  0
димом	дим                         noun:m:v_oru  0
Ми	ми                              pron:pers:p:1:v_naz:anim 0
раніше	раніше                      adv  0
цей	цей                             pron:dem   0
заклад	заклад                      noun:m:v_zna   0
але	але                             conj:coord   0
вже	вже                             adv:v-u  0
близько	близько                     adv:compb  0
року рік                            noun:m:v_rod 0
ні	ні                              part  0
ногою	нога                        noun:f:v_oru   -10
Офіціанти	офіціант                noun:p:v_naz:anim  0
можуть	могти                       verb:unknown  0
на	на                              prep:rv_mis  0
протязі	протяг                      noun:m:v_mis  0
навіть	навіть                      part  0
меню	меню                        noun:n:v_zna:nv  0
не	не                              part  0
принести	принести                verb:inf:perf   0
Дуже	дуже                        adv  0
шкода	шкода                       noun:f:v_naz  0
бо	бо                              conj:subord  0
місце	місце                       noun:n:v_naz  0
хороше	хороший                     adj:n:v_naz:compb   0
і	і                               conj:coord  0
кухня	кухня                       noun:f:v_naz  0
смачна	смачний                     adj:f:v_naz:compb  0
а	а                               conj:coord  0
от	от                              part  0
все	все                             adv:v-u  0
решта	решта                       noun:f:v_naz  0
одні	один                        numr:p:v_naz   0
мінуси	мінус                       noun:p:v_naz   0
Дуже	дужий                       adj:n:v_naz:compb  0
дивно	дивно                       adv:compb  0
роблячи	робити                      advp:imperf  -10
ремонт	ремонт                      noun:m:v_zna  0
не	не                              part  0
встановлення	встановлення        noun:n:v_zna:v-u  0
додаткових	додатковий              adj:p:v_zna  0
кондиціонерів	кондиціонер         noun:p:v_rod   0
Літом	літо                        noun:n:v_oru  0
в	в                               prep:v-u  0
як	як                              adv 0
в	в                               prep:rv_mis:v-u  0
ПЕКЛІ	пекло                       noun:n:v_mis 0
Це	цей                             pron:dem  0
просто	просто                      adv:compb  0
ЖАХ	жах                             noun:m:v_naz  -20
Якщо	якщо                        conj:subord  0
ви	ви                              pron:pers:p:2:v_naz:anim 0
себе	себе                        pron:refl:m:v_zna  0
елітним	елітний                     adj:m:v_oru   10
клубом	клуб                        noun:m:v_oru  10
то	то                              conj:subord  10
як	як                              adv 10
можна	можна                       predic  0
приємно	приємно                     adv:compb  0
відпочити	відпочити               verb:inf:perf  0
коли	коли                        adv  0
дихнути	дихнути                     verb:inf:perf  0
нема	нема                        predic  0
чим	що                              pron  0
я	я                               pron:pers:s:1:v_naz:anim 0
не	не                              part  0
говорю	говорити                    verb:pres:s:1:imperf  0
про	про                             prep:rv_zna  0
те	той                             pron:dem  0
щоб	щоб                             conj:subord   0
потанцювати	потанцювати             verb:inf:perf  0
При	при                             prep:rv_mis  0
чому	чому                        pron 0
крім	крім                        prep:rv_rod  0
входу	вхід                        noun:m:v_rod  0
тепер	тепер                       adv 0
платити	платити                     verb:inf:imperf  0
за	за                              prep:rv_zna 0
стіл	стіл                        noun:m:v_zna  0
грн	грн                             noun:f:v_zna:nv:abbr  0
і	і                               conj:coord   0
обслуговування	обслуговування      noun:n:v_zna  0
ви	ви                              pron:pers:p:2:v_naz:anim  0
включаєте	включати                verb:pres:p:2:imperf:v-u  0
в	в                               prep:v-u  0
рахунок	рахунок                     noun:m:v_zna  0
у	у                               prep:v-u  0
вас	ви                              pron:pers:p:2:v_rod:anim  0
нічогенькі	нічогенький             adj:p:v_naz  0
а	а                               conj:coord   0
рівень	рівень                      noun:m:v_naz  0
не	не                              part  0
дотягуєте	дотягувати              verb:pres:p:2:imperf   0
Шановна	шановний                    adj:f:v_naz  0
Оксано	Оксана                      noun:f:v_kly:anim:fname  0
нажаль	нажаль                      insert:bad  -20
не	не                              part  -20
можу	могти                       verb:unknown  0
погодитись	погодитися              verb:rev:inf:perf  10
з	з                               prep:rv_oru 0
вашими	ваш                         pron:pos  0
притензіями	                        bad 0
до	до                              prep:rv_rod  0
даного	даний                       adjp:pasv:past:m:v_rod  0
закладу	заклад                      noun:m:v_rod  0
Всі	весь                            pron:dem   0
прекрасно	прекрасно               adv:compb  0
у	у                               prep:v-u  0
Львові	Львів                       noun:m:v_mis  0
розумію	розуміти                    verb:pres:s:1:imperf  0
і	і                               conj:coord  0
знають	знати                       verb:pres:p:3:imperf  10
що	що                              conj:subord  0
воду	вода                        noun:f:v_zna  0
крану	кран                        noun:m:v_dav  0
пити	пити                        verb:inf:imperf  0
у	у                               prep:v-u  0
нас	ми                              pron:pers:p:1:v_rod:anim  0
не	не                              part  0
бажано	бажано                      predic  0
тому	тому                        adv  0
що	що                              conj:subord  0
вона	вона                        pron:pers:f:3:v_naz:anim  0
не	не                              part  0
відповідає	відповідати             verb:pres:s:3:imperf  0
жодним	жоден                       pron  0
стандартам	стандарт                noun:p:v_dav  0
і	і                               conj:coord  0
для	для                             prep:rv_rod  0
того	той                         pron:dem  0
щоб	щоб                             conj:subord  0
особисто	особисто                adv:compb  0
в	в                               prep:v-u  0
цьому	цей                         pron:dem 0
переконатись	переконатися        verb:rev:inf:perf  0
я	я                               pron:pers:s:1:v_naz:anim  0
відвідував	відвідувати             verb:past:m:imperf  0
споруди споруда                     verb:impr:s:2:perf   0
Нічого	нічого                      predic  0
і	і                               conj:coord  0
позитивного	позитивний              adj:n:v_rod:compb  0
я	я                               pron:pers:s:1:v_naz:anim 0
там	там                             pron:dem  0
не	не                              part  0
побачив	побачити                    verb:past:m:perf  0
А	а                               conj:coord  0
ви	ви                              pron:pers:p:2:v_naz:anim 0
б	б                               part  0
могли	могти                       verb:unknown  0
хоч	хоч                             con 0
на	на                              prep 0
хвильку	хвилька                     noun:f:v_zna  10
подумати	подумати                verb:inf:perf  0
про	про                             prep:rv_zna  0
те	той                             pron:dem  0
