Iryna 20-30 male
Але	                  conj:coord  0
А	                  conj:coord  0
Був	                  verb:past:m:imperf  0
Вам	                  pron:pers:p:2:v_dav:anim 0
Вибачте	              verb:impr:p:2:perf  -10
Видно	              insert  0
Виявилося	          verb:rev:past:n:perf  0
Все	                  adv:v-u  0
Декілька	          numr:p:v_rod:&pron:ind  0
Домі	              noun:m:v_mis  0
До	                  prep:rv_rod 0
Дуже	              adj:m:v_naz:compb  0
Дуже	              adv  0
Дякую	              verb:pres:s:1:imperf  10
Дім	                  noun:m:v_naz  0
Дім	                  noun:m:v_zna  0
Жахливе               adj:n:v_naz:compb  -10
Завжди	              adv:&pron:gen  0
Замовили	          verb:past:p:perf  0
Замовлення	          noun:n:v_naz 0
Зранку	              adv  0
І	                  conj:coord                               0
Їжа	                  noun:f:v_naz  0
Кухня	              noun:f:v_naz  0
Легенд	              noun:p:v_rod  0
Львові	              noun:m:v_dav  0
Львові	              noun:m:v_mis  0
Люди	              noun:p:v_naz:anim  0
Ми	                  pron:pers:p:1:v_naz:anim  0
На	                  prep:rv_mis  0
Нема	              predic  0
Не	                  part  0
Новий	              adj:m:v_zna:compb  0
Нового	              adj:m:v_zna:compb                            0
Ну	                  excl  0
Нічого	              predic  0
Одні	              numr:p:v_naz  0
Особливі	          adj:p:v_naz  10
Офіціант	          noun:m:v_naz:anim  0
Пиво	              noun:n:v_zna  0
Починайте	          verb:impr:p:2:imperf  0
По	                  prep:rv_mis:rv_zna  0
По-друге	          adv  0
По-перше	          adv  0
Прикро	              adv:compb  -10
Після	              adv   0
Розчарування	      noun:n:v_naz  -10
Рівно	              adv:compb  0
Сажотрус	          noun:m:v_naz:anim 0
Страва	              noun:f:v_naz   0
Так	                  adv:&pron:dem  0
Тарілка	              noun:f:v_naz  0
Тиждень	              noun:m:v_naz  0
Учора	              adv:v-u  0
ФЕСТ	              noun:m:v_naz:bad  0
Це	                  adj:n:v_naz:&pron:dem 0
Чому	              adv:&pron:int:rel  0
Шановні	              adj:p:v_kly  0
Якась	              pron:pers:f:3:v_naz 0
Я	                  pron:pers:s:1:v_naz:anim 0
аби	                  conj:subord  0
абсолютно	          adv  0
але	                  conj:coord 0
аніж	              conj:subord  0
аромату	              noun:m:v_rod  0
арт-директору	      noun:m:v_dav:anim  0
а	                  conj:coord  0
багатьох	          numr:p:v_mis:&pron:ind  0
бачила	              verb:past:f:imperf  0
бездарними	          adj:p:v_oru  -10
безкоштовному	      adj:m:v_dav  0
без	                  prep:rv_rod  0
би	                  part  0
близько	              adv:compb  0
бо	                  conj:subord  0
брудно	              adv:compb  0
буваю	              verb:pres:s:1:imperf  0
був	                  verb:past:m:imperf  0
будній	              adj:m:v_naz -10
буклеті	              noun:m:v_dav  0
була	              verb:past:f:imperf  0
були	              verb:past:p:imperf  0
було 	              verb:past:n:imperf  0
бігав	              verb:past:m:imperf  0
бігали	              verb:past:p:imperf  0
більше	              adv:compr                 0
б	                  part  0
вам	                  pron:pers:p:2:v_dav:anim  0
вбиральні	          noun:f:v_dav:v-u  0
вгодити	              verb:inf:perf:v-u  0
вдалося	              verb:rev:past:n:perf:v-u  0
вдома	              adv:v-u  0
велику	              adj:f:v_zna:compb  0
великі	              adj:p:v_naz:compb  0
величезний	          adj:m:v_naz  0
верхнього	          adj:m:v_mis 0
верхній	              adj:m:v_zna  0
взяти	              verb:inf:perf  0
видно	              predic  0
викликав	          verb:past:m:imperf  0
вимірі	              noun:m:v_dav  0
вирішили	          verb:past:p:perf  0
вирішили              verb:past:p:perf  0
вирішують	          verb:pres:p:3:imperf  0
витрачайте	          verb:impr:p:2:imperf  0
виходу	              noun:m:v_zna  0
виявився	          verb:rev:past:m:perf  0
ви	                  pron:pers:p:2:v_naz:anim  0
вказуєте	          verb:pres:p:2:imperf:v-u  0
води	              noun:p:v_zna  0
воно	              pron:pers:n:3:v_naz  0
впевнена	          adj:f:v_naz:compb:v-u:&adjp:pasv:past  0
впевнено              adv:compb:v-u   0
вперше 	              adv:v-u  0
вражений	          adjp:pasv:past:m:v_naz  10
враження              noun:n:v_naz                               10
все	                  adv:v-u  0
встиг	              verb:past:m:perf:v-u 0
всій	              adj:f:v_mis:&pron:dem  0
всім	              adj:p:v_dav:&pron:dem  0
всі	                  adj:p:v_naz:&pron:dem  0
вулиці	              noun:f:v_mis  0
вході	              noun:m:v_mis:v_dav  0
відвідати	          verb:inf:perf  0
відвідували	          verb:past:p:imperf  0
відвідувачів	      noun:p:v_rod:anim  0
відвідую	          verb:pres:s:1:imperf  0
відмовили	          verb:past:p:perf  0
відчула	              verb:past:f:perf  0
відчули	              verb:past:p:perf  0
від	                  prep:rv_rod  0
він	                  pron:pers:m:3:v_naz:anim  0
вітер	              noun:m:v_zna  0
вічно	              adv  0
в	                  prep 0
гарячого	          noun:p:v_zna  0
глечик	              noun:m:v_naz  0
година	              noun:f:v_naz  0
години	              noun:f:v_rod  0
годин	              noun:p:v_dav  0
голосно	              adv:compb  0
голос	              noun:m:v_naz  0
господарі	          noun:p:v_kly:anim anim  0
гостей	              noun:p:v_rod:anim  0
гостям	              noun:p:v_dav:anim 0
готуюсь	              verb:rev:pres:s:1:imperf  0
гривень	              noun:p:v_zna  0
гриль	              noun:m:v_zna  0
грн	                  noun:p:v_rod:nv:abbr  0
гроші	              noun:p:v_zna  0
гудзика	              noun:m:v_zna  0
гуморески             noun:p:v_zna  10
гірше 	              adj:n:v_naz:compr  -10
гіршого 	          adj:m:v_rod:compr  -10
дарував	              verb:past:m:imperf                                0
дві	                  numr:p:v_zna  0
день	              noun:m:v_naz  0
десь	              adv:&pron:ind  0
де	                  adv:&pron:int:rel  0
дизайнерам	          noun:p:v_dav:anim  0
днях	              noun:p:v_mis  0
довго	              adv:compb  0
долили	              verb:past:p:perf  0
долити	              verb:inf:perf  0
допомогла	          verb:past:f:perf  0
дорого	              adv:compb  -10
дорозі	              noun:f:v_mis  0
дочекавшись	          advp:rev:perf  0
дочекалися	          verb:rev:past:p:perf  0
до	                  prep 0
друзями	              noun:p:v_oru:anim  10
дуже	              adv                        0
думку	              noun:f:v_zna  0
душно	              adv  -10
дякую	              verb:pres:s:1:imperf  0
дівчина	              noun:f:v_naz:anim  0
дійсно	              adv  0
екскурсію	          noun:f:v_zna  0
емоція	              noun:f:v_naz  0
емоції	              noun:p:v_zna  0
жаль	              </insert>  -10
жахлива	              adj:f:v_naz:compb  -10
житті	              noun:n:v_rod  0
ж	                  part  0
забив	              verb:past:m:perf  -10
забув	              verb:past:m:perf  -10
заважаючи	          advp:imperf  0
закладу	              noun:m:v_rod  0
закладу	              noun:m:v_zna 0
заклад	              noun:m:v_zna  0
залишали	          verb:past:p:imperf  0
залишаєте	          verb:pres:p:2:imperf  0
зали	              noun:p:v_naz  0
замовили	          verb:past:p:perf  0
замовлений	          adjp:pasv:past:m:v_naz  0
замовлену	          adjp:pasv:past:f:v_zna  0
замовляли	          verb:past:p:imperf  0
замовчуєте	          verb:pres:p:2:imperf  0
запах	              noun:m:v_zna  0
заплатили	          verb:past:p:perf  0
заради	              prep:rv_rod  0
зараз	              adv:&pron:dem  0
зарезервувати	      verb:inf:perf  0
засушені	          adjp:pasv:past:p:v_zna  0
зателефонував	      verb:past:m:perf  0
захваті	              noun:m:v_mis  0
захоплюючі	          adjp:actv:pres:p:v_naz:bad 10
зачепивши	          advp:perf  0
заявити	              verb:inf:perf  0
за	                  prep 0
звичайним             adj:n:v_oru:compb 0
звісно	              adv  0
згадали	              verb:past:p:perf  0
згладжувало           verb:past:n:imperf  0
знайти	              verb:inf:perf  0
знаю	              verb:pres:s:1:imperf  0
зробити	              verb:inf:perf  0
зрозуміла	          verb:past:f:perf  0
зрозуміли	          verb:past:p:perf  0
зустрічали            verb:past:p:imperf  0
зі	                  prep:rv_oru 0
з	                  prep 0
його	              pron:pers:m:3:v_rod:anim 0
кави	              noun:p:v_rod  0
кави	              noun:p:v_zna  0
кадри	              noun:p:v_naz  0
картоплею	          noun:f:v_oru  0
кафе	              noun:n:v_oru:nv                               0
квас	              noun:m:v_zna  0
келих	              noun:m:v_zna  0
керують	              verb:pres:p:3:imperf  0
керівництву	          noun:n:v_dav  0
кожному	              adj:m:v_mis:&pron:def                                                          0
коли	              adv:&pron:int:rel  0
компанією             noun:f:v_oru  0
компанії	          noun:f:v_dav  0
конкурси              noun:p:v_naz                               0
котра	              adj:f:v_naz:&pron:int  0
краєвид	              noun:m:v_naz  0
крильця	              noun:p:v_zna  0
кричати	              verb:inf:imperf  0
крім	              prep:rv_rod  0
курку	              noun:f:v_zna:anim                             0
курятину	          noun:f:v_zna  0
кухарю	              noun:m:v_dav:anim rf  0
кухар	              noun:m:v_naz:anim  0
куштувала	          verb:past:f:imperf  0
кімнати	              noun:p:v_zna  0
кімнатної	          adj:f:v_rod  0
легендами	          noun:p:v_oru  0
легенди	              noun:p:v_zna  0
легенд	              noun:p:v_rod  0
ледь	              adv  0
людей	              noun:p:v_zna:anim  0
людину	              noun:f:v_zna:anim  0
люди	              noun:p:v_naz:anim  0
мабуть                insert  0
мав	                  verb:past:m:imperf  0
майже	              adv  0
маленькі	          adj:p:v_naz  0
мали	              verb:past:p:imperf  0
мало	              adv:compb  0
меню	              noun:n:v_dav:nv 0
минув	              verb:past:m:perf  0
ми	                  pron:pers:p:1:v_naz:anim  0
можливо	              adv  0
можливістю	          noun:f:v_rod  0
можна	              predic  0
момент	              noun:m:v_naz 0
моїм	              adj:m:v_oru:&pron:pos                                                     0
місце	              noun:n:v_naz  0
місце	              noun:n:v_zna  0
місцях	              noun:p:v_mis  0
місця	              noun:n:v_rod  0
м'ясну	              adj:f:v_zna  0
м'ясом	              noun:n:v_oru  0
набагато	          adv  0
навідуються	          verb:rev:pres:p:3:imperf 0
навіть	              part  0
награно	              adv  0
найдорожча	          adj:f:v_naz:super  -10
найкращі              adj:p:v_naz:super                             10
намагаючись	          advp:rev:imperf  0
нам	                  pron:pers:p:1:v_dav:anim  0
напевне	              adv  0
насолоджуватись	      verb:rev:inf:imperf  10
настоянки	          noun:p:v_zna  0
наступного	          adj:m:v_dav  0
настільки             adv  0
нас	                  pron:pers:p:1:v_zna:anim 0
нашим	              adj:n:v_oru:&pron:pos  0
наїдалися	          verb:rev:past:p:imperf  0
на	                  <insert>  0
на	                  part  0
на	                  prep:rv_mis  0
неймовірне	          adj:n:v_naz:compb 10
немає	              predic  0
немитого	          adj:n:v_rod  -10
непоганий	          adj:m:v_naz -10
несли	              verb:past:p:imperf  -10
неіснуючому	          adjp:actv:pres:m:v_dav:bad 0
не	                  part  0
ним	                  pron:pers:n:3:v_oru  0
новорічну             adj:f:v_zna  0
ногою	              noun:f:v_oru  0
нудно	              adv  0
нього	              pron:pers:m:3:v_rod:anim                                              0
нього	              pron:pers:m:3:v_zna:anim  0
ніде	              adv:&pron:neg  0
ніж	                  conj:subord   0
ній	                  pron:pers:f:3:v_mis:anim  0
нічого	              adv  0
нічого	              predic  0
нічого	              pron:neg:v_zna  0
ніч	                  noun:f:v_zna  0
ніяких	              adj:p:v_rod:&pron:neg  0
ні	                  part  0
обдаровані	          adjp:pasv:past:p:v_naz:compbjp:pasv:past:p:v_zna:compb 10
обслуги	              noun:f:v_rod  0
обслуговування	      noun:n:v_rod  0
обіцяли	              verb:past:p:imperf  0
овочевий	          adj:m:v_naz  0
овочевий	          adj:m:v_zna  0
один	              numr:m:v_naz  0
одна	              numr:f:v_naz  0
окреме	              adj:n:v_naz  0
окрім	              prep:rv_rod  0
оплатити	          verb:inf:perf  0
організаторів         noun:p:v_rod:anim  0
організувати	      verb:inf:perf  0
особливого	          adj:m:v_rod  10
останнього	          adj:m:v_dav  0
останнє	              adj 0
останній	          adj:m:v_naz 0
остаточно	          adv  0
ось	                  part  0
отож	              part  0
от	                  part  0
офіціанта	          noun:m:v_rod:anim  0
офіціантка	          noun:f:v_naz:anim  0
офіціантку	          noun:f:v_zna:anim  0
офіціант	          noun:m:v_naz:anim  0
очікування	          noun:n:v_rod  0
о	                  prep:rv_zna 0
папір	              noun:m:v_zna  0
переконались	      verb:rev:past:p:perf  0
пересмажена	          adjp:pasv:past:f:v_naz -10
пересолена	          adjp:pasv:past:f:v_naz -10
персоналу	          noun:m:v_rod  0
персонал	          noun:m:v_naz 0
пива	              noun:n:v_rod   0
пива	              noun:n:v_zna  0
пиво	              noun:n:v_zna  0
пиві	              noun:n:v_mis  0
пили	              verb:past:p:imperf  0
побували	          verb:past:p:perf  0
побувати	          verb:inf:perf  0
побігла	              verb:past:f:perf  0
поважати              verb:inf:imperf  0
повернусь	          verb:rev:futr:s:1:perf  0
поверхах	          noun:p:v_mis:dav 0
поверху	              noun:m:v_mis  0
поверх	              noun:m:v_zna  0
подали	              verb:past:p:perf  0
подати	              verb:inf:perf  0
подивитися	          verb:rev:inf:perf  0
позитивні             adj:p:v_zna:compb  10
попросили	          verb:past:p:perf  0
порції	              noun:p:v_zna  0
послухали             verb:past:p:perf  0
послухати	          verb:inf:perf  0
постійно              adv  0
потреш	              verb:futr:s:2:perf  0
потім	              adv:&pron:dem  0
по	                  prep:rv_mis:rv_dav  0
по	                  prep:rv_mis:rv_zna  0
привітаюсь	          verb:rev:futr:s:1:perf  0
привітливий	          adj:m:v_naz  0
прийду	              verb:futr:s:1:perf  0
прийшли	              verb:past:p:perf  0
прийшов	              verb:past:m:perf  0
приколи	              noun:p:v_zna  0
принесли	          verb:past:p:perf  0
принесу	              verb:futr:s:1:perf  0
притому	              conj:bad  0
приємний	          adj:m:v_naz:compb  10
приїду	              verb:futr:s:1:perf  0
проводив              verb:past:m:imperf  0
проколи	              noun:p:v_zna -10
просто	              part  0
проханням	          noun:n:v_oru 0
про	                  prep:rv_zna  0
півгодини	          noun:f:v_dav:nv:np  0
пів	                  noun:f:v_rod:nv:np  0
підлозі	              noun:f:v_mis  0
піду	              verb:futr:s:1:perf  0
підігрівали	          verb:past:p:imperf  0
пір	                  noun:p:v_rod  0
після	              prep:rv_rod  0
пішли	              verb:past:p:perf  0
раджу	              verb:pres:s:1:imperf  0
разу	              noun:m:v_dav  0
разів	              noun:p:v_rod  0
раз	                  noun:m:v_naz 0
рахунок	              noun:m:v_zna  0
репутацію	          noun:f:v_zna  0
речі	              noun:f:v_dav 0
робити	              verb:inf:imperf  0
роботу	              noun:f:v_zna  0
роздивляючись	      advp:rev:imperf  0
розкидано	          verb:impers:perf  0
розлютили	          verb:past:p:perf  -10
розмовою	          noun:f:v_od  0
розпечена	          adjp:pasv:past:f:v_naz  0
розповідав	          verb:past:m:imperf  0
розуміються	          verb:rev:pres:p:3:imperf  0
розчарований	      adjp:pasv:past:m:v_naz -10
розчарував	          verb:past:m:perf  -10
року	              noun:m:v_rod  0
різні	              adj:p:v_naz                                              0
рік	                  noun:m:v_zna 0
ріні	              adj:p:v_zna  0
сажотруса	          noun:m:v_rod:anim 0
сажотруса             noun:m:v_zna:anim  0
салат	              noun:m:v_naz  0
салат	              noun:m:v_zna  0
самий	              adj:m:v_zna  0
самим	              adj:n:v_oru:&pron:def  0
самі	              adj:p:v_naz:&pron:def  0
свининою	          noun:f:v_oru  0
свою	              adj:f:v_zna:&pron:pos  0
свідчить	          verb:pres:s:3:imperf  0
cвоїх	              adj:p:v_rod:&pron:pos  0
себе	              pron:refl:m:v_rod  0
себе	              pron:refl:n:v_zna  0
село	              noun:n:v_mis  0
середньому	          adj:m:v_dav  0
сиділи	              verb:past:p:imperf  0
сих	                  pron 0
сказала	              verb:past:f:perf  0
скибки	              noun:p:v_naz  0
скласти	              verb:inf:perf  0
скоромовки	          noun:p:v_naz  0
смачною	              adj:f:v_oru:compb  10
смачно	              adv:compb  10
смачнішого	          adj:m:v_rod:compr  10
сморід	              noun:m:v_naz  -10
соусом	              noun:m:v_oru  0
соусу	              noun:m:v_rod  0
спецій	              noun:p:v_rod  0
сподобалось	          verb:rev:past:n:perf  10
спочатку	          adv  0
став	              verb:past:m:perf  0
стану	              noun:m:v_rod   0
створювали	          verb:past:p:imperf  0
столик	              noun:m:v_zna  0
стояв	              verb:past:m:imperf  0
страва	              noun:f:v_naz  0
страви	              noun:p:v_naz  0
страву	              noun:f:v_zna  0
стіл	              noun:m:v_naz 0
суду	              noun:m:v_zna  0
сушимо	              verb:pres:p:1:imperf  0
сфотографуватися	  verb:rev:inf:perf  0
сходити	              verb:inf:imperf  0
схоже	              adj:n:v_naz  0
таке	              adj:n:v_zna:&pron:def  0
такий	              adj:m:v_naz:&pron:def  0
такого	              adj:m:v_rod:&pron:def 0
таку	              adj:f:v_zna:&pron:def  0
так	                  adv:&pron:dem  0
так	                  part  0
там	                  adv:&pron:dem 0
тарелю	              noun:f:v_zna  0
тарілку	              noun:f:v_zna  0
та	                  conj:coord 0
тебе	              pron:pers:s:2:v_zna:anim  0
тема	              noun:f:v_naz  0
темне	              adj:n:v_zna:compb  0
температури	          noun:f:v_rod  0
тепле	              adj:n:v_naz:compb  0
терасі	              noun:f:v_mis  0
те	                  adj:n:v_zna:&pron:dem  0
тим	                  adj:n:v_oru:&pron:dem                                                           0
ти	                  pron:pers:s:2:v_naz:anim  0
того	              part 0
той 	              adj 0
тому	              adv  0
точно	              adv  0
то	                  conj:subord  0
треба	              predic  0
три	                  numr:p:v_zna :imperf  0
туалетний	          adj:m:v_zna  0
туалеті	              noun:m:v_dav  0
туди	              adv:&pron:dem  0
туди-сюди	          adv  0
туристи	              noun:p:v_naz:anim  0
тут	                  adv:&pron:dem  0
тіла	              noun:n:v_rod 0
тільки	              adv  0
ті	                  adj:p:v_naz:&pron:dem  0
увесь	              pron:int:rel:m:v_naz  0
улюбленим	          adjp:pasv:past:n:v_oru:compb  10
унікальний	          adj:m:v_naz:compb  10
усмішкою	          noun:f:v_oru  10
у	                  prep:rv_dav:v-u  0
у	                  prep:rv_mis:v-u 0
у	                  prep:rv_zna:rv_mis:rv_rod:v-u  0
харчувалися	          verb:rev:past:p:imperf  0
хвилин	              noun:p:v_rod  0
хвостом	              noun:m:v_oru  0
химерне	              adj:n:v_zna  -10
хліба	              noun:m:v_rod  0
ходити	              verb:inf:imperf  0
хорошого	          adj:m:v_rod:compb  10
хоча	              conj:subord  0
хочу	              verb:pres:s:imperf  0
хоч	                  part  0
цей	                  adj:m:v_zna:&pron:dem  0
це	                  adj:n:v_naz:&pron:dem  0
це	                  part  0
цього	              adj:m:v_zna:&pron:dem 0
цього	              adj:n:v_rod:&pron:dem  0
цьому	              adj:m:v_dav:&pron:dem                              0
цікавого	          adj:m:v_rod:compb  10
ціни	              noun:p:v_naz  0
цін	                  noun:p:v_rod  0
часу	              noun:m:v_dav                              0
час	                  noun:m:v_naz  0
чекали	              verb:past:p:imperf  0
через	              prep:rv_dav  0
через	              prep:rv_zna  0
чоловіком	          noun:m:v_oru:anim  0
чому	              adv:&pron:int:rel is  0
чому	              pron:int:rel:n:v_dav                                0
чудові	              adj:p:v_naz:compb  0
швидко	              adv:compb  0
шукати	              verb:inf:imperf  0
ще	                  adv   0
ще	                  part  0
щоб	                  conj:subord  0
щодо	              prep:rv_rod  0
що	                  conj:subord    0
що	                  pron:int:rel:n:v_naz  0
якийсь	              adj:m:v_naz:&pron:ind  0
який	              adj:m:v_naz:&pron:int:rel:def 0
якомусь	              adj:m:v_dav:&pron:ind 0
якось	              adv:&pron:ind  0
якусь	              pron:pers:f:3:v_zna  0
яку	                  adj:f:v_zna:&pron:int:rel:def 0
які	                  adj:p:v_naz:&pron:int:rel:def  0
як	                  adv:&pron:int:rel                               0
як	                  conj:subord  0
як	                  part  0
я	                  pron:pers:s:1:v_naz:anim  0
єдина 	              adj:f:v_naz  0
єдиний	              adj:m:v_naz 0
є	                  verb:pres:p:3:imperf   0
із	                  prep:rv_zna 0
ім'я	              noun:n:v_zna  0
інтер'єр	          noun:m:v_zna  0
і	                  conj:coord                                              0
їси	                  verb:pres:s:2:imperf  0
її	                  pron:pers:f:3:v_rod:anim 0
її	                  pron:pers:f:3:v_zna:anim  0
0	                  number  0
10	                  number  0
100	                  number  0
18.30	              time  0
18.30	              time  0
2	                  number  0
2	                  number  0
20	                  number  0
200	                  number  0
30	                  number  0
4	                  number  0
50	                  number  0
70	                  number 0
