Sofiya Zaliska 20-30 female
1	                        number  0
10	                        number  0
100	                        number  0
16:30	                   	time  0
17	                        number  0
2	                        number  0
30-40	                    number  0
4	                        number  0
А	                     	conj:coord 0
Але	                        excl  0
Америки	                 	noun:f:v_rod  1
Близько      	           	adv:compb  5
Був	                        verb:past:m:imperf  0
Була	                    verb:past:f:imperf  1
В	               			prep:rv_mis:v-u  0
Вже         	            adv:v-u  0
Вона	                    pron:pers:f:3:v_naz:anim  0
Всім	               		adj:m:v_mis:&pron:dem (pron:pers:m:3:v_dav:anim) 0
Відвідали	            	verb:past:p:perf  2
Вітаю	                  	verb:pres:s:1:imperf  15
Гриль	                    noun:m:v_zna  2
До	                        prep:rv_rod  0
Дуже	                    adv 30
Дякую	                 	verb:pres:s:1:imperf  8
За	                        prep:rv_rod 0
Завжди	                   	adv:&pron:gen  2
Звичайно     	         	adv:compb  0
Кожного      	          	adj:m:v_rod:&pron:def  0
Коли	                    conj:subord  0
Кілька	             		noun:f:v_naz:anim (numr:p:v_rod:&pron:ind ) 0
Лат	                        noun:m:v_naz (noun:f:v_rod) 0
Львова        	            noun:m:v_rod  10
Мексиканець	         		noun:m:v_naz:anim (noun:m:v_zna:anim ) 1
Ми	                        pron:pers:p:1:v_naz:anim 0
Моя	                        adj:f:v_naz:&pron:pos  0
Не	                        part  -1
Неймовірно	           		adv:compb  30
Непогано     	        	adv  7
Ну	                        excl 0
Ні	                        part  -5
Обслуговування	   			noun:n:v_naz  4
Отож	                   	part  0
По	                        prep:rv_mis  0
Приємно      	         	adv:compb  18
Салати	                   	noun:p:v_naz 4
Стейк	                    noun:m:v_naz  1
Тому	                    conj:subord 0
Чудовий	                 	adj:m:v_naz:compb  31
Щоб	                        part  0
Я	                        pron:pers:s:1:v_naz:anim  0
Якщо	                    conj:subord  0
алкоголь	             	noun:m:v_zna  -1
антураж	                  	noun:m:v_naz 2
балансі	                   	noun:m:v_mis(noun:m:v_rod)  1
батьками	               	noun:p:v_oru:anim  6
батьки	                   	noun:p:v_naz:anim  3
бельгійського	     		adj:n:v_rod  6
бо                          conj:subord 0
бомба        	            noun:f:v_naz  11
був	                    	verb:past:m:imperf  1
будуть	                    verb:futr:p:3:imperf  2
будьте	                    verb:impr:p:3:imperf  1
була	                    verb:past:f:imperf  1
було        	            verb:past:n:imperf  1
в	                        prep:rv_mis::v-u  0
вам	                        pron:pers:p:2:v_dav:anim  0
вас	                        pron:pers:p:2:v_mis:anim  0
вашому        	            adj:m:v_mis:&pron:pos  0
вверх	                 	adv:v-u  4
ввічливий	            	adj:m:v_naz:v-u 39
велика	                	adj:f:v_naz:compb  6
великі         	         	adj:p:v_naz:compb 3
вже	                        adv:v-u  0
взагалі	                  	adv:v-u  1
вибачився	           		verb:rev:past:m:perf  2
виклику     	          	noun:m:v_rod  0
випадково	            	adv  3
висоті      	           	noun:f:v_mis  5
вказаного	             	adjp:pasv:past:m:v_rod:v-u 2
вказати	                 	verb:inf:perf:v-u  2
включили	             	verb:past:p:perf:v-u  1
вкотре	                   	adv:v-u  3
вони	                    pron:pers:p:3:v_naz:anim  0
вражений	           		adjp:pasv:past:m:v_naz 22
враження	             	noun:n:v_naz  12
вразило      	         	verb:past:n:perf  8
все	                        adv:v-u (pron:pers:m:3:v_naz:anim) 0
всі	                        adj:p:v_zna:&pron:dem 0
всіх           	       		adj:p:v_mis:&pron:dem (pron:pers:m:3:v_rod:anim) 1
входив       	          	verb:past:m:imperf  2
вчора	                    adv:v-u  1
від	                        prep:rv_rod  0
відвідування 	     		noun:n:v_rod  2
відвідувати	                verb:inf:imperf  2
відгуком       	           	noun:m:v_oru  2
відняли      	          	verb:past:p:perf  -7
він                         pron:pers:m:3:v_naz:anim  0
години	                   	noun:f:v_rod 0
годину	                   	noun:f:v_zna  0
гострий	                  	adj:m:v_naz:compb  -3
грн	                        noun:p:v_zna:nv:abbr  0
даного       	            adjp:pasv:past:m:v_rod  1
дегустував   	      		verb:past:m:imperf 2
декілька	            	numr:p:v_naz:&pron:ind 0
день	                    noun:m:v_zna  0
для	                        prep:rv_rod  0
добре	                    adv 19
довго          	            adv:compb  -2
доволі	                   	adv  4
додатковою	            	adj:f:v_oru  9
доклали	                 	verb:past:p:perf  2
досить       	           	adv   2
достатку	            	noun:m:v_rod  4
дочекалась	           		verb:rev:past:f:perf  2
дуже	                    adv  15
ж              	            part  0
жахливе      	        	adj:n:v_naz:compb  -30
жодного	                  	adj:m:v_rod:&pron  -2
жодному	                   	adj:n:v_mis:&pron  -1
з	                        prep:rv_oru 0
за           	            prep:rv_zna 0
забули	                   	verb:past:p:perf  -4
загалом	                  	adv 1
заклад	                   	noun:m:v_naz  2
закладу	                   	noun:m:v_rod  3
закладі	                    noun:m:v_mis  0
залишились   	       		verb:rev:past:p:perf  1
замовив	               		verb:past:m:perf  1
замовили	             	verb:past:p:perf  2
замовиш      	         	verb:futr:s:2:perf  2
замовлений	           		adjp:pasv:past:m:v_naz  2
замовлення	          		noun:n:v_rod   1
замовляв	            	verb:past:m:imperf  0
замовляла    	        	verb:past:f:imperf  2
замовлялися	          		verb:rev:past:p:imperf  2
замість	                  	prep:rv_rod  -1
зауваження	           		noun:n:v_zna  -6
звісно	                  	adv  2
згадали      	          	verb:past:p:perf  3
здивований	           		adjp:pasv:past:m:v_naz 12
здивували	           		verb:past:p:perf  13
знайти	                  	verb:inf:perf  1
зразу                       adv  10
зробив	                  	verb:past:m:perf  1
зробили      	           	verb:past:p:perf  1
його	                	adj:n:nv:&pron:pos 0
клієнти	                    noun:p:v_naz:anim  0
клієнткою	            	noun:f:v_oru:anim  4
кнопочок    	         	noun:p:v_rod  0
кожного      	          	adj:m:v_rod:&pron:def 0
коли	                    conj:subord  1
колись         	           	adv:&pron:ind 0
концентрація	     		noun:f:v_naz  4
крах        	            noun:m:v_naz   -19
круглу         	          	adj:f:v_zna  0
кукурудзою	             	noun:f:v_oru  2
легенького	            	adj:m:v_rod 10
м'яса          	            noun:n:v_rod  2
майже	                    adv   -1
маю	                        verb:pres:s:1:imperf 0
межі         	            noun:p:v_zna  0
мене	                    pron:pers:s:1:v_rod:anim  0
меню                        noun:n:v_mis:nv  0
мені	                    pron:pers:s:1:v_dav:anim  0
ми	                        pron:pers:p:1:v_naz:anim  0
мого	                    adj:n:v_rod:&pron:pos  0
можу         	           	verb:unknown  0
молоді	                  	noun:f:v_rod  3
морожене	          		adjp:pasv:past:n:v_naz -7
моїм          	            adj:m:v_oru:&pron:pos 0
мінус	                    noun:m:v_naz -3
місяць	                   	noun:m:v_zna  0
на	                    	prep:rv_zna:rv_mis  0
нагло          	            adv  -6
над	                        prep:rv_oru  0
надто       	            adv  5
нажаль      		         insert:bad  -5
наливають	            	verb:pres:p:3:imperf  1
нам          	            pron:pers:p:1:v_dav:anim 0
намагались	          		verb:rev:past:p:imperf  2
наприклад	            	insert  0
напрямку	             	noun:m:v_mis 0
насправді	            	adv 0
наявності	           	 	noun:f:v_mis  0
не	                    	part  -1
незважаючи	           		prep  1
нереально	           		adv  -10
низька       	          	adj:f:v_naz:compb  -9
нового       	            adj:n:v_rod:compb  12
ну	                        excl  1
нього	                    pron:pers:m:3:v_zna:anim 0
нічого        	            pron:neg:v_rod  -7
о	                        prep:rv_zna:rv_mis  0
оближеш	                	verb:futr:s:2:perf  6
огидним	                	adj:n:v_oru:compb  -20
один	                    numr:m:v_naz 0
одну         	            numr:f:v_zna  0
одразу	                    adv  7
опис	                    noun:m:v_zna  0
отримала	             	verb:past:f:perf  0
офіціанта     	         	noun:m:v_rod:anim 0
офіціантка	           		noun:f:v_naz:anim  0
офіціанту	             	noun:m:v_dav:anim  0
охолоджену	          		adjp:pasv:past:f:v_zna  2
оцінка	                 	noun:f:v_naz  0
пальчики	              	noun:p:v_zna  1
пару          	            noun:f:v_zna  2
перейшло     	          	verb:past:n:perf  -4
переконати	         		verb:inf:perf  3
перестали      	        	verb:past:p:perf  -3
персоналі	            	noun:m:v_mis  0
перців         	            noun:p:v_rod  1
пива	                    noun:n:v_rod  3
пивного	                   	adj:m:v_rod  1
пиво	                	noun:n:v_zna  1
пильні       	            adj:p:v_naz:compb -2
по           	            prep:rv_zna  0
подача	                   	noun:f:v_naz  2
позитивні	          		adj:p:v_naz:compb 27
постійно    	         	adv  3
постійною	            	adj:f:v_oru  2
потреби      	         	noun:f:v_rod 0
працювати	        		verb:inf:imperf  1
привабливі	          		adj:p:v_naz:compb 37
прийшла	                  	verb:past:f:perf  1
прийшли	                   	verb:past:p:perf  
прикро	                	adv:compb  -4
принесли	             	verb:past:p:perf  1
принесуть      	         	verb:futr:p:3:perf  1
приносячи    	       		advp:imperf  2
принципі	              	noun:m:v_mis  0
прискіпливий 	     		adj:m:v_naz:compb  -3
приходила	            	verb:past:f:imperf  1
приємний	             	adj:m:v_naz:compb 34
приємно	               		adv:compb  29
про	                        prep:rv_zna  0
прожарений	           		adjp:pasv:past:m:v_naz  15
прожарки	             	noun:f:v_rod:np:bad  1
простенький    	    	 	adj:m:v_naz 2
просто	                   	adv:compb 2
професійний	          		adj:m:v_naz:compb 21
пюре          	            noun:n:v_naz:nv  2
підозру	                  	noun:f:v_zna  -4
підряд        	           	noun:m:v_naz (adv)  0
піца	                    noun:f:v_naz  1
піцу	                    noun:f:v_zna  0
раджу	                   	verb:pres:s:1:imperf  20
разу	                    noun:m:v_rod  0
разів	                    noun:p:v_rod  0
рамках	                    noun:p:v_mis  1
рахунок     	          	noun:m:v_zna  6
результаті	            	noun:m:v_mis  1
рекомендую	                verb:pres:s:1:imperf  10
розпитувала	          		verb:past:f:imperf  1
розчаровуюсь	  			verb:rev:pres:s:1:imperf -9
розчарувалась	    		verb:rev:past:f:perf  -8
років       	            noun:p:v_rod  0
рубати	                  	verb:inf:imperf  -3
різноманіттям	     		noun:n:v_oru  3
салат	                   	noun:m:v_zna  11
сам	                        adj:m:v_naz:&pron:def 0
саме         	            part 0
своїм	                    adj:n:v_oru:&pron:pos  0
середнього	             	adj:m:v_rod  2
сиром          	            noun:m:v_oru  0
сказала	                 	verb:past:f:perf  2
смак                    	noun:m:v_zna  1
смаком	                	noun:m:v_oru  1
смаку	                    noun:m:v_rod  4
смачні	                  	adj:p:v_naz:compb  10
солений	                  	adjp:pasv:past:m:v_naz -3
солідно	                  	adv:compb  2
сподобався	          		verb:rev:past:m:perf  21
справа	                    noun:f:v_naz  2
справді	                  	adv  0
стейк	                    noun:m:v_naz  3
стейках	                    noun:p:v_mis  1
стейки	                   	noun:p:v_naz  1
страви	                    noun:p:v_zna  4
ступінь	                  	noun:m:v_naz  0
стільки	                  	numr:p:v_zna:&pron:ind  0
суми	                    noun:f:v_rod  2
суміш	                    noun:f:v_zna  2
супу	                    noun:m:v_rod  2
суші           	      		noun:p:v_naz 1
сьогодні	             	adv  0
сік          	            noun:m:v_zna 1
та	                     	conj:coord (pron:ind:s:v_naz:anim)  0
та	                        conj:coord 0
так          	            part  0
таке	                    adj:n:v_naz:&pron:def  0
такий	                  	adj:m:v_naz:&pron:def 0
таку	                    adj:f:v_zna:&pron:def  0
там	                        adv:&pron:dem  0
те           	            adj:n:v_zna:&pron:dem  0
тижнів	                 	noun:p:v_rod  0
тим	                        adj:m:v_oru:&pron:dem 0
то	                        conj:subord  0
той          	            adj:m:v_zna:&pron:dem  0
тому	                    adv 0
топовий                  	adj:m:v_naz 31
точний	                   	adj:m:v_zna:compb  3
ту           	            adj:f:v_zna:&pron:dem  0
туди	                    adv:&pron:dem  0
туру	                    noun:m:v_rod  1
тут	                    	adv:&pron:dem  0
у	                    	prep:rv_zna:rv_mis:rv_rod:v-u  0
хвилин	                    noun:p:v_rod  0
хлопцем        	          	noun:m:v_oru:anim  0
ходжу        	         	verb:pres:s:1:imperf  1
ходити       	          	verb:inf:imperf  2
хороший	                  	adj:m:v_naz:compb 14
хороші         	          	adj:p:v_naz:compb 14
хтось	                   	pron:ind:v_naz:anim  0
це	                    	adj:n:v_naz:&pron:dem (part) 0
центрі	                    noun:m:v_mis  6
цьому	                    adj:m:v_mis:&pron:dem 0
цікаво	                  	adv:compb  11
цікаві	                 	adj:p:v_naz:compb  15
ціна	                    noun:f:v_naz  0
ціни	                    noun:p:v_naz  0
ціну	                    noun:f:v_zna  0
часу	                    noun:m:v_rod  0
чекала	                   	verb:past:f:imperf  -2
чекали         	            verb:past:p:imperf  -1
чекаю	                   	verb:pres:s:1:imperf  -1
чеку	                    noun:m:v_mis  0
чим	                        pron:int:rel:n:v_oru  0
чогось	                    pron:ind:n:v_rod 0
ще	                        part  0
що	                        pron:int:rel:n:v_zna  0
щоразу	                	adv  2
я	                        pron:pers:s:1:v_naz:anim  0
як	                        conj:subord  0
якесь	                   	adj:n:v_zna:&pron:ind  0
який         	            adj:m:v_zna:&pron:int:rel:def 0
якийсь	                  	adj:m:v_zna:&pron:ind  0
які         	            adj:p:v_naz:&pron:int:rel:def 0
якість	                  	noun:f:v_naz  3
якісь          	            adj:p:v_naz:&pron:ind  0
яловичину	            	noun:f:v_zna  3
є	                        verb:pres:p:2:imperf   0
єдиний	                   	adj:m:v_naz  5
і	                    	conj:coord   0
ідентичне    	       		adj:n:v_naz 2
інгредієнти  	       		noun:p:v_naznoun:p:v_zna  1
інтер'єр	            	noun:m:v_naz  5
іншому        	           	adj:m:v_mis:&pron:def  1
їм	                        pron:pers:p:3:v_dav:anim 0
їх           	            pron:pers:p:3:v_zna:anim 0
її	                        pron:pers:f:3:v_zna:anim 0