Sofiya Zaliska 20-30 female
1	                        number  0
10	                        number  0
100	                        number  0
16:30	                   	time  0
17	                        number  0
17:08	                    time  0
2	                        number  0
30-40	                    number  0
4	                        number  0
480	                        number  0
5	                        number  0
800	                        number  0
А	                     	conj:coord 0
Але                         conj:coord  0
Америки	                 	noun:f:v_rod  1
Барви	                 	noun:p:v_naz 2
Близько      	           	adv:compb  5
Блюзу	                	noun:m:v_rod  2
Був	                        verb:past:m:imperf  0
Була	                    verb:past:f:imperf  1
Більше	         			adv:compr  9
В	               			prep:rv_mis:v-u  0
Вам	                        pron:pers:p:2:v_dav:anim 0
Вас	                        pron:pers:p:2:v_rod:anim  0
Ваша	                    adj:f:v_naz:&pron:pos  0
Ваше	                    adj:n:v_naz:&pron:pos (pron:rel:p:1:v_rod:anim) 0
Вашого	                    adj:m:v_rod:&pron:pos  0
Вже         	            adv:v-u  0
Ви	                        pron:pers:p:2:v_naz:anim 0
Вибирав	                  	verb:past:m:imperf  1
Вона	                    pron:pers:f:3:v_naz:anim  0
Всім	               		adj:m:v_mis:&pron:dem (pron:pers:m:3:v_dav:anim) 0
Відвідали	            	verb:past:p:perf  2
Вітаю	                  	verb:pres:s:1:imperf  15
Гарного	                   	adj:m:v_rod:compb  13
Гриль	                    noun:m:v_zna  2
До	                        prep:rv_rod  0
Доброго	                   	adj:m:v_rod:compb 17
Дуже	                    adv 30
Дякую	                	verb:pres:s:1:imperf  13
З            	            prep:rv_oru  0
За	                        prep:rv_rod 0
Завжди	                   	adv:&pron:gen  2
Заклад	                  	noun:m:v_naz  2
Звичайно     	         	adv:compb  0
Ковбой                      noun:m:v_naz:anim  4
Кожного      	          	adj:m:v_rod:&pron:def  0
Коли	                    conj:subord  0
Кілька	             		noun:f:v_naz:anim (numr:p:v_rod:&pron:ind ) 0
Лас-Вегас    	       		noun:m:v_naz  6
Лат	                        noun:m:v_naz (noun:f:v_rod)                                   0
Львова        	            noun:m:v_rod  10
Львові	                    noun:m:v_mis  12
Мексиканець	         		noun:m:v_naz:anim (noun:m:v_zna:anim ) 1
Ми	                        pron:pers:p:1:v_naz:anim 0
Москви	                  	noun:f:v_rod  0
Моя	                        adj:f:v_naz:&pron:pos  0
Нарешті	                  	adv   5
Не	                        part  -1
Неймовірно	           		adv:compb  30
Непогано     	        	adv  7
Ну	                        excl 0
Ні	                        part  -5
Обслуговування	   			noun:n:v_naz  4
Олександр	            	noun:m:v_naz:anim:fname  0
Олена	                  	noun:f:v_naz:anim:fname 0
Отож	                   	part  0
ПОВНІСТЮ     	          	adv  11
Панове	                    noun:p:v_kly:anim  5
По	                        prep:rv_mis  0
Подзвонили    	       		verb:past:p:perf  0
Пояснюю	                	verb:pres:s:1:imperf 0
Приємно      	         	adv:compb  18
Про	                        prep:rv_zna  0
Піца	                    noun:f:v_naz  2
Піцу	                    noun:f:v_zna  2
Салати	                   	noun:p:v_naz 4
Сиру	                    adj:f:v_zna  -26
Стейк	                    noun:m:v_naz  1
Стейки	                    noun:p:v_naz  5
Сьогодні	             	adv  0
Тому	                    conj:subord 0
Уругваю	                	noun:m:v_rod  0
Успіхів	                    noun:p:v_rod  16
ЦІЛКОМ	                    adv   23
Ціни	                    noun:p:v_naz  0
Чому	                    adv:&pron:int:rel  0
Чудовий	                 	adj:m:v_naz:compb  31
Шановні	                  	adj:p:v_naz (noun:m:v_kly) 4
Шатобріан	         		noun:m:v_naz:anim:lname  0
Шкода	                   	noun:f:v_naz  -10
Щоб	                        part  0
Я	                        pron:pers:s:1:v_naz:anim  0
Якщо	                    conj:subord  0
а	                        conj:coord  0
адже	                    conj:subord 0
алкоголь	             	noun:m:v_zna  -1
антураж	                  	noun:m:v_naz 2
багато        	            adv   12
бажаю	                  	verb:pres:s:1:imperf  22
балансі	                   	noun:m:v_mis(noun:m:v_rod)  1
батьками	               	noun:p:v_oru:anim  6
батьки	                   	noun:p:v_naz:anim  3
бельгійського	     		adj:n:v_rod  6
близько	                 	adv:compb  2
бо                          conj:subord 0
боку         	            noun:m:v_rod  0
бомба        	            noun:f:v_naz  11
брала	                  	verb:past:f:imperf  2
був	                    	verb:past:m:imperf  1
бувати	                    verb:inf:imperf 2
будуть	                    verb:futr:p:3:imperf  2
будь-яких	            	adj:p:v_rod:&pron:ind  0
будьте	                    verb:impr:p:3:imperf  1
була	                    verb:past:f:imperf  1
було        	            verb:past:n:imperf  1
більше                      adv:compr  9
в	                        prep:rv_mis::v-u  0
важко	                    adv:compb  -2
вам	                        pron:pers:p:2:v_dav:anim  0
вас	                        pron:pers:p:2:v_mis:anim  0
вашого	                    adj:m:v_rod:&pron:pos  0
вашому        	            adj:m:v_mis:&pron:pos  0
вважаю        	         	verb:pres:s:1:imperf  0
вверх	                 	adv:v-u  4
ввічливий	            	adj:m:v_naz:v-u 39
ввічливості  	       		noun:f:v_rod:v-u  -6
велика	                	adj:f:v_naz:compb  6
велика	                    adj:f:v_naz:compb  24
великі         	         	adj:p:v_naz:compb 3
вести	                    verb:inf:imperf  0
вже	                        adv:v-u  0
взагалі	                  	adv:v-u  1
взяли	                   	verb:past:p:perf  0
вибачився	           		verb:rev:past:m:perf  2
вибачтесь	            	verb:rev:impr:p:2:perf  2
викидати	             	verb:inf:imperf  -6
виклику     	          	noun:m:v_rod  0
випадково	            	adv  3
вирішили	              	verb:past:p:perf  0
висловити	           		verb:inf:perf  2
висоті      	           	noun:f:v_mis  5
виставляючи   	       		advp:imperf  4
вихідних	               	adj:p:v_mis 7
вище         	            adv:compr:compr  10
вказаного	             	adjp:pasv:past:m:v_rod:v-u 2
вказати	                 	verb:inf:perf:v-u  2
включили	             	verb:past:p:perf:v-u  1
вкотре	                   	adv:v-u  3
власників	               	noun:p:v_rod:anim  0
вона	                    pron:pers:f:3:v_naz:anim  0
вони	                    pron:pers:p:3:v_naz:anim  0
вражена	               		adjp:pasv:past:f:v_naz  9
вражений	           		adjp:pasv:past:m:v_naz 22
враження	            	noun:n:v_zna  10
вразило      	         	verb:past:n:perf  8
все          	            part:v-u 0
вступати	             	verb:inf:imperf  1
вступають    	          	verb:pres:p:3:imperf  1
всього       	         	adj:m:v_rod:&pron:dem (pron:def:rel:n:v_rod) 11
всі	                        adj:p:v_zna:&pron:dem 0
всім	                    adj:p:v_dav:&pron:dem  0
всіх           	       		adj:p:v_mis:&pron:dem (pron:pers:m:3:v_rod:anim) 1
входив       	          	verb:past:m:imperf  2
вході	                    noun:m:v_mis  0
вчора	                    adv:v-u  1
від	                        prep:rv_rod  0
відвідування 	     		noun:n:v_rod  2
відвідувати	                verb:inf:imperf  2
відвідувачем	        	noun:m:v_oru:anim  0
відвідувачів	       		noun:p:v_rod:anim 0
відвідую	          		verb:pres:s:1:imperf  0
відгуки	                 	noun:p:v_zna  0
відгуком       	           	noun:m:v_oru  2
відношенню	           		noun:n:v_dav  2
відняли      	          	verb:past:p:perf  -7
відпочинку	         		noun:m:v_rod  8
відсвяткувати	     		verb:inf:perf  8
він                         pron:pers:m:3:v_naz:anim  0
генделик	        		noun:m:v_zna  -4
години	                   	noun:f:v_rod 0
годину	                   	noun:f:v_zna  0
гостей	                   	noun:p:v_zna:anim  8
гострий	                  	adj:m:v_naz:compb  -3
гривен	                   	noun:p:v_rod  0
гриль	                    noun:m:v_zna  0
грн	                        noun:p:v_zna:nv:abbr  0
гроші	                    noun:p:v_zna  0
грубими	                    adj:p:v_oru:compb  -11
давайте	                  	verb:impr:p:2:imperf  0
даний	                  	adjp:pasv:past:m:v_zna  0
даного       	            adjp:pasv:past:m:v_rod  1
де            	            adv:&pron:int:rel (conj:subord)  0
дегустував   	      		verb:past:m:imperf 2
декілька	            	numr:p:v_naz:&pron:ind 0
декількох	            	numr:p:v_rod:&pron:ind 0
день	                    noun:m:v_zna  0
директору	           		noun:m:v_dav:anim  0
дискусію	              	noun:f:v_zna  2
для	                        prep:rv_rod  0
дня	                        noun:m:v_rod  0
до	            			prep:rv_rod  0
добре	                    adv 19
довго          	            adv:compb  -2
доволі	                   	adv  4
додатковою	            	adj:f:v_oru  9
доклали	                 	verb:past:p:perf  2
дописувачів   	         	noun:p:v_rod:anim  0
дорого	                  	adv:compb  -5
дорогі	                  	adj:p:v_naz:compb  -5
досить       	           	adv   2
достатку	            	noun:m:v_rod  4
досі	                    adv:&pron:dem 0
дочекалась	           		verb:rev:past:f:perf  2
драйвова	           		adj:f:v_naz:slang  15
друзями	                    noun:p:v_oru:anim 17
друзі	                    noun:p:v_kly:anim 17
дуже         	            adv 28
думаю	                  	verb:pres:s:1:imperf  1
думку	                   	noun:f:v_zna  2
душі	                    noun:f:v_rod  4
дядько	                    noun:m:v_naz:anim  3
дівчатам	      			noun:p:v_dav:anim  3
дівчинка	             	noun:f:v_naz:anim  3
ж	                        part  0
жахливе      	        	adj:n:v_naz:compb  -30
животи	                  	noun:p:v_zna  0
житі	                    noun:n:v_mis  0
жодного	                  	adj:m:v_rod:&pron  -2
жодному	                   	adj:n:v_mis:&pron  -1
з	                        prep:rv_oru 0
за           	            prep:rv_zna 0
забули	                   	verb:past:p:perf  -4
загалом	                  	adv 1
заклад	                  	noun:m:v_zna   0
заклад	                   	noun:m:v_naz  2
закладу     	            noun:m:v_rod 0
закладі	                   	noun:m:v_mis  0
закусках     	            noun:p:v_mis  2
залишають	            	verb:pres:p:3:imperf  1
залишені	             	adjp:pasv:past:p:v_zna  1
залишили	              	verb:past:p:perf  1
залишились   	       		verb:rev:past:p:perf  1
залі	                    noun:m:v_mis  2
замало      	           	adv  -4
замовив	               		verb:past:m:perf  1
замовили	             	verb:past:p:perf  2
замовити	             	verb:inf:perf  2
замовиш      	         	verb:futr:s:2:perf  2
замовлений	           		adjp:pasv:past:m:v_naz  2
замовлення	          		noun:n:v_rod   1
замовляв	            	verb:past:m:imperf  0
замовляла    	        	verb:past:f:imperf  2
замовляли	             	verb:past:p:imperf  2
замовлялися	          		verb:rev:past:p:imperf  2
замість	                  	prep:rv_rod  -1
запах        	          	noun:m:v_naz   4
заплатив     	         	verb:past:m:perf  0
заплатили	            	verb:past:p:perf  0
запросіть	             	verb:impr:p:2:perf  9
заради	             	    prep:rv_rod  2
зараз	                    adv:&pron:dem 0
засунути	           		verb:inf:perf  0
зателефонувала	   			verb:past:f:perf  0
затишний	            	adj:m:v_naz:compb  9
зауваження	           		noun:n:v_zna  -6
захочу	                 	verb:unknown  0
звертати    	        	verb:inf:imperf  0
звісно	                  	adv  2
згадали      	          	verb:past:p:perf  3
згадую	                	verb:pres:s:1:imperf  0
здивований	           		adjp:pasv:past:m:v_naz 12
здивували	           		verb:past:p:perf  13
здогадатися	           		verb:rev:inf:perf  0
знайомих	              	noun:p:v_rod:anim  3
знайти	                  	verb:inf:perf  1
знаю	                    verb:pres:s:1:imperf 0
знають        	            verb:pres:p:3:imperf  0
знаючи	                   	advp:imperf  0
зовсім	                 	adv  -4
зору         	            noun:m:v_rod  0
зразу                       adv  10
зробив	                  	verb:past:m:perf  1
зробили      	           	verb:past:p:perf  1
й	                        conj:coord  0
його           	            pron:pers:m:3:v_zna:anim 0
кажете	                   	verb:pres:p:2:imperf  0
картку	                   	noun:f:v_zna  0
картоплі	           	 	noun:f:v_rod 2
класне	                 	adj:n:v_naz  12
клієнта     	          	noun:m:v_rod:anim 0
клієнти	                    noun:p:v_naz:anim  0
клієнткою	            	noun:f:v_oru:anim  4
клієнтів    	            noun:p:v_rod:anim  0
кнопочок    	         	noun:p:v_rod  0
кожен	                	adj:m:v_naz:contr  0
кожного      	          	adj:m:v_rod:&pron:def 0
коли	                    conj:subord  1
колись              		adv:&pron:ind  0
коментарі	             	noun:p:v_zna  0
компанія	               	noun:f:v_naz  9
комусь	                    pron:ind:v_dav:anim  0
концентрація	     		noun:f:v_naz  4
крах        	            noun:m:v_naz   -19
краще	         			adj:n:v_naz:compr (adv) 29
круглу         	          	adj:f:v_zna  0
куди	                    adv:&pron:int:rel  0
кукурудзи	             	noun:f:v_rod  0
кукурудзою	             	noun:f:v_oru  2
кухня	                  	noun:f:v_naz  0
кухні	                    noun:f:v_rod  0
кістці	                	noun:f:v_mis  0
легенького	            	adj:m:v_rod 10
люди	                    noun:p:v_naz:anim  0
людьми	                    noun:p:v_oru:anim  0
м'яса          	            noun:n:v_rod  2
м'ясо                       noun:n:v_naz 3
майбутніх    	      		adj:p:v_rod  0
майже	                    adv  0
майте	                    verb:impr:p:2:imperf 0
манеру	                    noun:f:v_zna  1
маю	                        verb:pres:s:1:imperf 0
межі         	            noun:p:v_zna  0
мене	                    pron:pers:s:1:v_rod:anim  0
менше        	           	adv:compr  -4
меню	                    noun:n:v_naz:nv 0
мені	                    pron:pers:s:1:v_dav:anim  0
ми	                        pron:pers:p:1:v_naz:anim  0
миле	                   	adj:n:v_zna:compb  24
минулих     	           	adjp:actv:past:p:v_rod  0
мого	                    adj:n:v_rod:&pron:pos  0
може	                   	verb:unknown  0
можете        	            verb:unknown  0
можливості	           		noun:f:v_dav 0
можу	                    verb:unknown  0
молоді	                  	noun:f:v_rod  3
морожене	          		adjp:pasv:past:n:v_naz -7
моїм          	            adj:m:v_oru:&pron:pos 0
музика	                 	noun:f:v_naz   3
мінус	                    noun:m:v_naz -3
міста                      	noun:n:v_rod  0
місце         	           	noun:n:v_zna  0
місяць	                   	noun:m:v_zna  0
місяців                    	noun:p:v_rod  0
на	                    	prep:rv_zna:rv_mis  0
нагло          	            adv  -6
над	                        prep:rv_oru  0
надто       	            adv  5
нажаль      		         insert:bad  -5
найкращими	            	adj:p:v_oru:super  19
наливають	            	verb:pres:p:3:imperf  1
нам          	            pron:pers:p:1:v_dav:anim 0
намагались	          		verb:rev:past:p:imperf  2
напевно	                  	adv  0
наприклад	            	insert  0
напрямку	             	noun:m:v_mis 0
нас	                        pron:pers:p:1:v_rod:anim 0
насправді	            	adv 0
настрій     	          	noun:m:v_zna  15
настільки	             	adv  0
начинки	                   	noun:f:v_rod 1
нашого	                    adj:m:v_rod:&pron:pos  0
наявності	           	 	noun:f:v_mis  0
не	                    	part  -1
неадекватними	      		adj:p:v_oru  -17
негарно                    	adv  -20
негативом	             	noun:m:v_oru  -20
недопустиму	          		adj:f:v_zna  -30
незважаючи	           		prep  1
нема        	            predic  -16
неперевершена	  			adj:f:v_naz:&adjp:pasv:past  17
неприємний   	      		adj:m:v_naz:compb  -25
нереально	           		adv  -10
нижньому	               	adj:m:v_mis  -9
низька       	          	adj:f:v_naz:compb  -9
нового       	            adj:n:v_rod:compb  12
ну	                        excl  1
нього	                    pron:pers:m:3:v_zna:anim 0
ній	                        pron:pers:f:3:v_mis:anim  0
нічого	                    pron:neg:v_rod  -6
о	                        prep:rv_zna:rv_mis  0
оближеш	                	verb:futr:s:2:perf  6
обслуговування	  			noun:n:v_naz  0
овочів                      noun:p:v_rod 0
огидним	                	adj:n:v_oru:compb  -20
один	                    numr:m:v_naz 0
один         	            numr:m:v_zna  0
одне	                    numr:n:v_zna  0
одну         	            numr:f:v_zna  0
одразу	                    adv  7
опис	                    noun:m:v_zna  0
особливо	          	 	adv   9
от           	            part  0
отримала	             	verb:past:f:perf  0
офіціанта     	         	noun:m:v_rod:anim 0
офіціантка	           		noun:f:v_naz:anim  0
офіціанту	             	noun:m:v_dav:anim  0
офіціантів	             	noun:p:v_rod:anim   0
охолоджену	          		adjp:pasv:past:f:v_zna  2
оцінка	                 	noun:f:v_naz  0
оцінювати	          		verb:inf:imperf  0
пальчики	              	noun:p:v_zna  1
пару          	            noun:f:v_zna  2
перед	                  	noun:m:v_naz (prep:rv_oru) 0
перейшло     	          	verb:past:n:perf  -4
переконати	         		verb:inf:perf  3
переконатися	      		verb:rev:inf:perf  5
перервою	              	noun:f:v_oru   0
перестали      	        	verb:past:p:perf  -3
персоналі	            	noun:m:v_mis  0
перців         	            noun:p:v_rod  1
пива	                    noun:n:v_rod  3
пивного	                   	adj:m:v_rod  1
пиво	                	noun:n:v_zna  1
пильні       	            adj:p:v_naz:compb -2
плісняви	             	noun:f:v_rod  -27
по            	            prep:rv_zna  0
побажаннями	         	  	noun:p:v_oru  15
побував	                  	verb:past:m:perf  1
повагою	                  	noun:f:v_oru  16
повториться 	       		verb:rev:futr:s:3:perf  2
погане	                  	adj:n:v_naz:compb  -31
подача	                   	noun:f:v_naz  2
подзвонити	          		verb:inf:perf  0
позитивні	          		adj:p:v_naz:compb 27
позитивом	            	noun:m:v_oru  22
поміняв	                  	verb:past:m:perf  0
пора	                    noun:f:v_naz  0
порогу	                    noun:m:v_dav ( noun:m:v_rod) 0
порції	                 	noun:p:v_zna  0
постійно    	         	adv  3
постійного	           	 	adj:m:v_rod 5
постійною	            	adj:f:v_oru  2
потреби      	         	noun:f:v_rod 0
похвал	                   	noun:p:v_rod  27
поєднанні	           	 	noun:n:v_mis  0
працювати	        		verb:inf:imperf  1
працюють    	       		verb:pres:p:3:imperf  0
працює	        			verb:pres:s:3:imperf  0
працівники    	       		noun:p:v_naz:anim  0
працівників  	         	noun:p:v_rod:anim  0
привабливі	          		adj:p:v_naz:compb 37
привозять	            	verb:pres:p:3:imperf  0
привітна     	       		adj:f:v_naz:compb  21
прийти	                	verb:inf:perf  0
прийшла	                  	verb:past:f:perf  1
прийшли     	           	verb:past:p:perf  1
прикро	                	adv:compb  -4
принесли	    		 	verb:past:p:perf  0
принесуть      	         	verb:futr:p:3:perf  1
приносячи    	       		advp:imperf  2
принципі	              	noun:m:v_mis  0
прискіпливий 	     		adj:m:v_naz:compb  -3
пристойному	            	adj:m:v_mis  18
приходила	            	verb:past:f:imperf  1
приходьте      	        	verb:impr:p:2:imperf  0
приємний	             	adj:m:v_naz:compb 34
приємно	                  	adv:compb  41
про	                        prep:rv_zna  0
прожарений	           		adjp:pasv:past:m:v_naz  15
прожарки	             	noun:f:v_rod:np:bad  1
простенький    	    	 	adj:m:v_naz 2
просто	                   	adv:compb 2
професійний	          		adj:m:v_naz:compb 21
процвітання	           		noun:n:v_rod 32
прочитавши   	         	advp:perf  0
прочитала	            	verb:past:f:perf  0
прямо	                   	adv:compb  0
псувати       	          	verb:inf:imperf  -16
псує        	          	verb:pres:s:3:imperf  -16
псуєте	                   	verb:pres:p:2:imperf  -16
пюре          	            noun:n:v_naz:nv  2
підемо	                   	verb:futr:p:1:perf  0
підозру	                  	noun:f:v_zna  -4
підряд        	           	noun:m:v_naz (adv)  0
підставляти	         		verb:inf:imperf  -17
підходить	          		verb:pres:s:3:imperf  0
піти	                    verb:inf:perf 0
піца	                    noun:f:v_naz  1
піцу	                    noun:f:v_zna  1
раджу	                   	verb:pres:s:1:imperf  20
раз	                        noun:m:v_zna  0
разу	                    noun:m:v_rod  0
разів	                	noun:p:v_rod  0
рамках	                    noun:p:v_mis  1
рахунок     	          	noun:m:v_zna  6
реалізовані	        		adjp:pasv:past:p:v_zna  12
результаті	            	noun:m:v_mis  1
рейсом	                    noun:m:v_oru  0
рекомендую	                verb:pres:s:1:imperf  10
репутацію	             	noun:f:v_zna  6
ресурсі	                   	noun:m:v_mis  0
риба	                    noun:f:v_naz:anim  0
розпитувала	          		verb:past:f:imperf  1
розуміють	           		verb:pres:p:3:imperf  0
розчаровуюсь	  			verb:rev:pres:s:1:imperf -9
розчарувалась	    		verb:rev:past:f:perf  -8
років       	            noun:p:v_rod  0
рубати	                  	verb:inf:imperf  -3
рівні	                    noun:m:v_mis 0
різноманіттям	     		noun:n:v_oru  3
салат	                   	noun:m:v_zna  11
салат	                    noun:m:v_naz  4
салатом	                    noun:m:v_oru  0
салату                  	noun:m:v_rod 0
сам	                        adj:m:v_naz:&pron:def 0
саме	                    part  0
самі        	            adj:p:v_naz:&pron:def 0
свою	                    adj:f:v_zna:&pron:pos (pron:refl:v_naz) 0
своє	                    adj:n:v_naz:&pron:pos (pron:pos:s:1:v_naz:anim) 0
своїм	                    adj:n:v_oru:&pron:pos  0
своїх	                    adj:p:v_mis:&pron:pos (pron:refl:v_rod:anim) 0
себе	                    pron:refl:m:v_zna 0
середнього	             	adj:m:v_rod  2
сиділи	                   	verb:past:p:imperf  0
сира	                    adj:f:v_naz  -16
сиром          	            noun:m:v_oru  0
сирою        	            adj:f:v_oru  -16
сирувате	         		adj:n:v_naz   -16
сказала	                 	verb:past:f:perf  2
сказати	                   	verb:inf:perf  0
смак	                    noun:m:v_naz  4
смаком	                	noun:m:v_oru  1
смаку	                    noun:m:v_rod  4
смачні	                  	adj:p:v_naz:compb  10
собою	                    pron:refl:m:v_oru  0
собі	                    pron:refl:m:v_dav  0
солений	                  	adjp:pasv:past:m:v_naz -3
солідно	                  	adv:compb  2
сперечаюсь	        		verb:rev:pres:s:1:imperf  -3
сподобався	          		verb:rev:past:m:perf  21
сподобалася	           		verb:rev:past:f:perf  22
справа	                    noun:f:v_naz  2
справді	                  	adv  0
спробувати	            	verb:inf:perf  2
спілкування	           		noun:n:v_rod  6
стейк	                    noun:m:v_naz  3
стейках      	            noun:p:v_mis 3
стейки	                   	noun:p:v_naz  1 5
столик	                  	noun:m:v_zna  0
стосується   	       		verb:rev:pres:s:3:imperf  0
стоїть	                  	verb:pres:s:3:imperf  0
страви	                    noun:p:v_zna  4
ступінь	                  	noun:m:v_naz  0
стільки	                  	numr:p:v_zna:&pron:ind  0
суми	                    noun:f:v_rod  2
суміш	                    noun:f:v_zna  2
супу	                    noun:m:v_rod  2
суші           	      		noun:p:v_naz 1
схвальні	            	adj:p:v_zna  16
сьогодні	             	adv  0
сік          	            noun:m:v_zna 1
та           	            conj:coord  0
так	                        adv:&pron:dem 0
таке	                    adj:n:v_naz:&pron:def  0
таки        	            part  0
такий	                  	adj:m:v_naz:&pron:def 0
такого	                    adj:m:v_rod:&pron:def  0
також         	            adv  0
таку	                    adj:f:v_zna:&pron:def  0
такі         	           	adj:p:v_zna:&pron:def  0
там	                        adv:&pron:dem  0
тарілки	                  	noun:p:v_zna  0
тверезо	                	adv:compb  9
те           	            adj:n:v_zna:&pron:dem  0
тепер	                    adv:&pron:dem  0
теперішніх     	        	adj:p:v_rod  0
тижнів	                 	noun:p:v_rod  0
тим	                        adj:m:v_oru:&pron:dem  0
тим	                        adj:m:v_oru:&pron:dem 0
тих	                        adj:p:v_rod:&pron:dem  0
то	                        conj:subord  0
той          	            adj:m:v_zna:&pron:dem  0
толк	                    noun:m:v_zna u  0
тому	                    adv 0
топовий                  	adj:m:v_naz 31
точку	                    noun:f:v_zna 0
точний	                   	adj:m:v_zna:compb  3
точно	                    adv  0
трошки      	            adv  0
ту           	            adj:f:v_zna:&pron:dem  0
туди	                    adv:&pron:dem  0
туру	                    noun:m:v_rod  1
тут	                    	adv:&pron:dem  0
у	                    	prep:rv_zna:rv_mis:rv_rod:v-u  0
увагу                 		noun:f:v_zna 5
фантастично	         	 	adv:compb  23
харизматичний	      		adj:m:v_naz  26
хвилин	                    noun:p:v_rod  0
хлопцем        	          	noun:m:v_oru:anim  0
ходжу        	         	verb:pres:s:1:imperf  1
ходити       	          	verb:inf:imperf  2
хороше	            	   	adj:n:v_naz:compb  19
хороший	                  	adj:m:v_naz:compb 14
хороші         	          	adj:p:v_naz:compb 14
хотілося	             	verb:unknown  1
хоч	                        part  0
хто	                        pron:int:rel:m:v_naz:anim 0
хтось	                   	pron:ind:v_naz:anim  0
це	                    	adj:n:v_naz:&pron:dem (part) 0
центрі	                    noun:m:v_mis  6
цим	                        adj:m:v_oru:&pron:dem 0
цього	                    adj:m:v_rod:&pron:dem 0
цьому	        			adj:m:v_mis:&pron:dem 0
ці	                     	adj:p:v_zna:&pron:dem  0
цікаво	                  	adv:compb  11
цікаві	                 	adj:p:v_naz:compb  15
ціна	                    noun:f:v_naz  0
ціни	                    noun:p:v_naz  0
ціну	                    noun:f:v_zna  0
чартерним	            	adj:m:v_oru 0
частіше	                    adv:compr  6
часу	                    noun:m:v_rod  0
чекала	                   	verb:past:f:imperf  -2
чекали         	            verb:past:p:imperf  -1
чекаю	                   	verb:pres:s:1:imperf  -1
чеку	                    noun:m:v_mis  0
чесно	                   	adv:compb 9
чи	                        conj:coord:subord 0
чим	                        pron:int:rel:n:v_oru  0
чого	                    pron:int:rel:n:v_rod  0
чогось	                    pron:ind:n:v_rod 0
чоловіку	              	noun:m:v_dav:anim  0
чув	                        verb:past:m:imperf  0
чітко	                   	adv:compb  6
ще	                        part  0
що             	            conj:subord 0
щоб                     	conj:subord 0
щодо          	            prep:rv_rod  0
щоп'ятниці	           		adv  0
щоразу	                	adv  2
я	                        pron:pers:s:1:v_naz:anim  0
як	                        conj:subord  0
якесь	                   	adj:n:v_zna:&pron:ind  0
який	                    adj:m:v_naz:&pron:int:rel:def (conj:subord) 0
який         	            adj:m:v_zna:&pron:int:rel:def 0
якийсь	                  	adj:m:v_naz:&pron:ind 0
яку	                       	adj:f:v_zna:&pron:int:rel:def 0
якщо	                    conj:subord  0
які	                        adj:p:v_naz:&pron:int:rel:def 0
якість	                  	noun:f:v_naz  3
якісь          	            adj:p:v_naz:&pron:ind  0
яловичину	            	noun:f:v_zna  3
є	                        verb:pres:p:2:imperf   0
єдиний	                   	adj:m:v_naz  5
і	                    	conj:coord   0
ідентичне    	       		adj:n:v_naz 2
ідіть	                    verb:impr:p:2:imperf  0
із	                        prep:rv_oru 0
імені	                    noun:n:v_rod  0
інгредієнти  	       		noun:p:v_naznoun:p:v_zna  1
інтер'єр	            	noun:m:v_naz  5
іншому        	           	adj:m:v_mis:&pron:def  1
їй           	            pron:pers:f:3:v_dav:anim  0
їм	                        pron:pers:p:3:v_dav:anim 0
їх           	            pron:pers:p:3:v_zna:anim 0
її	                        pron:pers:f:3:v_rod:ani 0