Sofiya Zaliska 20-30 female
17:08	                    time  0
2	                        number  0
4	                        number  0
480	                        number  0
5	                        number  0
800	                        number  0
Барви	                 	noun:p:v_naz 2
Блюзу	                	noun:m:v_rod  2
Була	                    verb:past:f:imperf  1
Більше	         			adv:compr  9
Вам	                        pron:pers:p:2:v_dav:anim 0
Вас	                        pron:pers:p:2:v_rod:anim  0
Ваша	                    adj:f:v_naz:&pron:pos  0
Ваше	                    adj:n:v_naz:&pron:pos (pron:rel:p:1:v_rod:anim) 0
Вашого	                    adj:m:v_rod:&pron:pos  0
Ви	                        pron:pers:p:2:v_naz:anim 0
Вибирав	                  	verb:past:m:imperf  1
Гарного	                   	adj:m:v_rod:compb  13
Доброго	                   	adj:m:v_rod:compb 17
Дуже	              	    adv  29
Дякую	                	verb:pres:s:1:imperf  13
З            	            prep:rv_oru  0
За	                        prep:rv_zna 0
Заклад	                  	noun:m:v_naz  2
Ковбой                      noun:m:v_naz:anim  4
Лас-Вегас    	       		noun:m:v_naz  6
Львові	                    noun:m:v_mis  12
Москви	                  	noun:f:v_rod  0
Нарешті	                  	adv   5
Олександр	            	noun:m:v_naz:anim:fname  0
Олена	                  	noun:f:v_naz:anim:fname 0
ПОВНІСТЮ     	          	adv  11
Панове	                    noun:p:v_kly:anim  5
Подзвонили    	       		verb:past:p:perf  0
Пояснюю	                	verb:pres:s:1:imperf 0
Про	                        prep:rv_zna  0
Піца	                    noun:f:v_naz  2
Піцу	                    noun:f:v_zna  2
Сиру	                    adj:f:v_zna  -26
Стейки	                    noun:p:v_naz  5
Сьогодні	             	adv  0
Уругваю	                	noun:m:v_rod  0
Успіхів	                    noun:p:v_rod  16
ЦІЛКОМ	                    adv   23
Ціни	                    noun:p:v_naz  0
Чому	                    adv:&pron:int:rel  0
Шановні	                  	adj:p:v_naz (noun:m:v_kly) 4
Шатобріан	         		noun:m:v_naz:anim:lname  0
Шкода	                   	noun:f:v_naz  -10
адже	                    conj:subord 0
але	                        conj:coord  0
багато        	            adv   12
бажаю	                  	verb:pres:s:1:imperf  22
близько	                 	adv:compb  2
боку         	            noun:m:v_rod  0
брала	                  	verb:past:f:imperf  2
бувати	                    verb:inf:imperf 2
будь-яких	            	adj:p:v_rod:&pron:ind  0
була	                    verb:past:f:imperf 0
було                     	verb:past:n:imperf  0
більше                      adv:compr  9
важко	                    adv:compb  -2
вашого	                    adj:m:v_rod:&pron:pos  0
вважаю        	         	verb:pres:s:1:imperf  0
ввічливості  	       		noun:f:v_rod:v-u  -6
велика	                    adj:f:v_naz:compb  24
вести	                    verb:inf:imperf  0
взагалі      	        	adv:v-u  0
взяли	                   	verb:past:p:perf  0
вибачтесь	            	verb:rev:impr:p:2:perf  2
викидати	             	verb:inf:imperf  -6
випадково	            	adv  -2
вирішили	              	verb:past:p:perf  0
висловити	           		verb:inf:perf  2
виставляючи   	       		advp:imperf  4
вихідних	               	adj:p:v_mis 7
вище         	            adv:compr:compr  10
власників	               	noun:p:v_rod:anim  0
вона	                    pron:pers:f:3:v_naz:anim  0
вражена	               		adjp:pasv:past:f:v_naz  9
враження	            	noun:n:v_zna  10
вступати	             	verb:inf:imperf  1
вступають    	          	verb:pres:p:3:imperf  1
всього       	         	adj:m:v_rod:&pron:dem (pron:def:rel:n:v_rod) 11
всі	                        adj:p:v_naz:&pron:dem  0
всім	                    adj:p:v_dav:&pron:dem  0
вході	                    noun:m:v_mis  0
від	                        prep:rv_rod  0
відвідувачем	        	noun:m:v_oru:anim  0
відвідувачів	       		noun:p:v_rod:anim 0
відвідую	          		verb:pres:s:1:imperf  0
відгуки	                 	noun:p:v_zna  0
відношенню	           		noun:n:v_dav  2
відпочинку	         		noun:m:v_rod  8
відсвяткувати	     		verb:inf:perf  8
генделик	        		noun:m:v_zna  -4
гостей	                   	noun:p:v_zna:anim  8
гривен	                   	noun:p:v_rod  0
гриль	                    noun:m:v_zna  0
гроші	                    noun:p:v_zna  0
грубими	                    adj:p:v_oru:compb  -11
давайте	                  	verb:impr:p:2:imperf  0
даний	                  	adjp:pasv:past:m:v_zna  0
де            	            adv:&pron:int:rel (conj:subord)  0
декілька	             	numr:p:v_zna:&pron:ind  0
декількох	            	numr:p:v_rod:&pron:ind 0
директору	           		noun:m:v_dav:anim  0
дискусію	              	noun:f:v_zna  2
для	                        prep:rv_rod  0
дня	                        noun:m:v_rod  0
до	            			prep:rv_rod  0
дописувачів   	         	noun:p:v_rod:anim  0
дорого	                  	adv:compb  -5
дорогі	                  	adj:p:v_naz:compb  -5
досить	                    adv   0
досі	                    adv:&pron:dem 0
драйвова	           		adj:f:v_naz:slang  15
друзями	                    noun:p:v_oru:anim 17
друзі	                    noun:p:v_kly:anim 17
думаю	                  	verb:pres:s:1:imperf  1
думку	                   	noun:f:v_zna  2
душі	                    noun:f:v_rod  4
дядько	                    noun:m:v_naz:anim  3
дівчатам	      			noun:p:v_dav:anim  3
дівчинка	             	noun:f:v_naz:anim  3
животи	                  	noun:p:v_zna  0
житі	                    noun:n:v_mis  0
за	                        prep:rv_rod:rv_zna:rv_oru 0
заклад	                  	noun:m:v_zna   0
закладу     	            noun:m:v_rod 0
закладі	                   	noun:m:v_mis  0
закусках     	            noun:p:v_mis  2
залишають	            	verb:pres:p:3:imperf  1
залишені	             	adjp:pasv:past:p:v_zna  1
залишили	              	verb:past:p:perf  1
залі	                    noun:m:v_mis  2
замало      	           	adv  -4
замовити	             	verb:inf:perf  2
замовлення	          		noun:n:v_zna  2
замовляли	             	verb:past:p:imperf  2
запах        	          	noun:m:v_naz   4
заплатив     	         	verb:past:m:perf  0
заплатили	            	verb:past:p:perf  0
запросіть	             	verb:impr:p:2:perf  9
заради	             	    prep:rv_rod  2
зараз	                    adv:&pron:dem 0
засунути	           		verb:inf:perf  0
зателефонувала	   			verb:past:f:perf  0
затишний	            	adj:m:v_naz:compb  9
захочу	                 	verb:unknown  0
звертати    	        	verb:inf:imperf  0
згадую	                	verb:pres:s:1:imperf  0
здогадатися	           		verb:rev:inf:perf  0
знайомих	              	noun:p:v_rod:anim  3
знаю	                    verb:pres:s:1:imperf 0
знають        	            verb:pres:p:3:imperf  0
знаючи	                   	advp:imperf  0
зовсім	                 	adv  -4
зору         	            noun:m:v_rod  0
й	                        conj:coord  0
його           	            pron:pers:m:3:v_zna:anim 0
кажете	                   	verb:pres:p:2:imperf  0
картку	                   	noun:f:v_zna  0
картоплі	           	 	noun:f:v_rod 2
класне	                 	adj:n:v_naz  12
клієнта     	          	noun:m:v_rod:anim 0
клієнтів    	            noun:p:v_rod:anim  0
кожен	                	adj:m:v_naz:contr  0
колись              		adv:&pron:ind  0
коментарі	             	noun:p:v_zna  0
компанія	               	noun:f:v_naz  9
комусь	                    pron:ind:v_dav:anim  0
краще	         			adj:n:v_naz:compr (adv) 29
куди	                    adv:&pron:int:rel  0
кукурудзи	             	noun:f:v_rod  0
кухня	                  	noun:f:v_naz  0
кухні	                    noun:f:v_rod  0
кістці	                	noun:f:v_mis  0
люди	                    noun:p:v_naz:anim  0
людьми	                    noun:p:v_oru:anim  0
м'ясо                       noun:n:v_naz 3
майбутніх    	      		adj:p:v_rod  0
майже	                    adv  0
майте	                    verb:impr:p:2:imperf 0
манеру	                    noun:f:v_zna  1
маю                        	verb:pres:s:1:imperf 0
менше        	           	adv:compr  -4
миле	                   	adj:n:v_zna:compb  24
минулих     	           	adjp:actv:past:p:v_rod  0
може	                   	verb:unknown  0
можете        	            verb:unknown  0
можливості	           		noun:f:v_dav 0
можу	                    verb:unknown  0
музика	                 	noun:f:v_naz   3
міста                      	noun:n:v_rod  0
місце         	           	noun:n:v_zna  0
місяців                    	noun:p:v_rod  0
на	                        prep:rv_mis  0
найкращими	            	adj:p:v_oru:super  19
нам                         pron:pers:p:1:v_dav:anim 0
напевно	                  	adv  0
нас	                        pron:pers:p:1:v_rod:anim 0
настрій     	          	noun:m:v_zna  15
настільки	             	adv  0
начинки	                   	noun:f:v_rod 1
нашого	                    adj:m:v_rod:&pron:pos  0
неадекватними	      		adj:p:v_oru  -17
негарно                    	adv  -20
негативом	             	noun:m:v_oru  -20
недопустиму	          		adj:f:v_zna  -30
нема        	            predic  -16
неперевершена	  			adj:f:v_naz:&adjp:pasv:past  17
неприємний   	      		adj:m:v_naz:compb  -25
нижньому	               	adj:m:v_mis  -9
ній	                        pron:pers:f:3:v_mis:anim  0
нічого	                    pron:neg:v_rod  -6
обслуговування	  			noun:n:v_naz  0
овочів                      noun:p:v_rod 0
один         	            numr:m:v_zna  0
одне	                    numr:n:v_zna  0
одразу	                    adv  0
особливо	          	 	adv   9
от           	            part  0
офіціантів	             	noun:p:v_rod:anim   0
оцінювати	          		verb:inf:imperf  0
перед	                  	noun:m:v_naz (prep:rv_oru) 0
переконатися	      		verb:rev:inf:perf  5
перервою	              	noun:f:v_oru   0
пива	                    noun:p:v_zna  2
плісняви	             	noun:f:v_rod  -27
по	                        prep:rv_mis:rv_zna ( prep:rv_dav) 0
побажаннями	         	  	noun:p:v_oru  15
побував	                  	verb:past:m:perf  1
повагою	                  	noun:f:v_oru  16
повториться 	       		verb:rev:futr:s:3:perf  2
погане	                  	adj:n:v_naz:compb  -31
подзвонити	          		verb:inf:perf  0
позитивом	            	noun:m:v_oru  22
поміняв	                  	verb:past:m:perf  0
пора	                    noun:f:v_naz  0
порогу	                    noun:m:v_dav ( noun:m:v_rod) 0
порції	                 	noun:p:v_zna  0
постійного	           	 	adj:m:v_rod 5
похвал	                   	noun:p:v_rod  27
поєднанні	           	 	noun:n:v_mis  0
працюють    	       		verb:pres:p:3:imperf  0
працює	        			verb:pres:s:3:imperf  0
працівники    	       		noun:p:v_naz:anim  0
працівників  	         	noun:p:v_rod:anim  0
привозять	            	verb:pres:p:3:imperf  0
привітна     	       		adj:f:v_naz:compb  21
прийти	                	verb:inf:perf  0
прийшла	                   	verb:past:f:perf  0
принесли	    		 	verb:past:p:perf  0
пристойному	            	adj:m:v_mis  18
приходьте      	        	verb:impr:p:2:imperf  0
приємно	                   	adv:compb  28
процвітання	           		noun:n:v_rod 32
прочитавши   	         	advp:perf  0
прочитала	            	verb:past:f:perf  0
прямо	                   	adv:compb  0
псувати       	          	verb:inf:imperf  -16
псує        	          	verb:pres:s:3:imperf  -16
псуєте	                   	verb:pres:p:2:imperf  -16
підемо	                   	verb:futr:p:1:perf  0
підставляти	         		verb:inf:imperf  -17
підходить	          		verb:pres:s:3:imperf  0
піти	                    verb:inf:perf 0
раз	                        noun:m:v_zna  0
разів	                    noun:p:v_rod  0
реалізовані	        		adjp:pasv:past:p:v_zna  12
рейсом	                    noun:m:v_oru  0
репутацію	             	noun:f:v_zna  6
ресурсі	                   	noun:m:v_mis  0
риба	                    noun:f:v_naz:anim  0
розуміють	           		verb:pres:p:3:imperf  0
рівні	                    noun:m:v_mis 0
салатом	                    noun:m:v_oru  0
салату                  	noun:m:v_rod 0
сам         	            adj:m:v_naz:&pron:def (pron:refl:v_naz) 0
саме	                    part  0
самі        	            adj:p:v_naz:&pron:def 0
свою	                    adj:f:v_zna:&pron:pos (pron:refl:v_naz) 0
своє	                    adj:n:v_naz:&pron:pos (pron:pos:s:1:v_naz:anim) 0
своїх	                    adj:p:v_mis:&pron:pos (pron:refl:v_rod:anim) 0
себе	                    pron:refl:m:v_zna 0
сиділи	                   	verb:past:p:imperf  0
сира	                    adj:f:v_naz  0
сира	                    adj:f:v_naz  -16
сирою        	            adj:f:v_oru  -16
сирувате	         		adj:n:v_naz   -16
сказати	                   	verb:inf:perf  0
смак	                    noun:m:v_naz  4
собою	                    pron:refl:m:v_oru  0
собі	                    pron:refl:m:v_dav  0
сперечаюсь	        		verb:rev:pres:s:1:imperf  -3
сподобався	          		verb:rev:past:m:perf  22
сподобалася	           		verb:rev:past:f:perf  22
спробувати	            	verb:inf:perf  2
спілкування	           		noun:n:v_rod  6
стейк	                    noun:m:v_naz  3
стейках      	            noun:p:v_mis 3
стейки	                   	noun:p:v_zna  3
столик	                  	noun:m:v_zna  0
стосується   	       		verb:rev:pres:s:3:imperf  0
стоїть	                  	verb:pres:s:3:imperf  0
схвальні	            	adj:p:v_zna  16
таке         	            adj:n:v_naz:&pron:def  0
таки        	            part  0
такого	                    adj:m:v_rod:&pron:def  0
також         	            adv  0
такі         	           	adj:p:v_zna:&pron:def  0
там	                        adv:&pron:dem 0
тарілки	                  	noun:p:v_zna  0
тверезо	                	adv:compb  9
тепер	                    adv:&pron:dem  0
теперішніх     	        	adj:p:v_rod  0
тим	                        adj:m:v_oru:&pron:dem  0
тих	                        adj:p:v_rod:&pron:dem  0
толк	                    noun:m:v_zna u  0
точку	                    noun:f:v_zna 0
точно	                    adv  0
трошки      	            adv  0
ту           	            adj:f:v_zna:&pron:dem  0
увагу                 		noun:f:v_zna 5
фантастично	         	 	adv:compb  23
харизматичний	      		adj:m:v_naz  26
хвилин      	          	noun:p:v_rod  0
хороше	            	   	adj:n:v_naz:compb  19
хотілося	             	verb:unknown  1
хоч	                        part  0
хто	                        pron:int:rel:m:v_naz:anim 0
цим	                        adj:m:v_oru:&pron:dem 0
цього	                    adj:m:v_rod:&pron:dem 0
цьому	        			adj:m:v_mis:&pron:dem 0
ці	                     	adj:p:v_zna:&pron:dem  0
ціну	                   	noun:f:v_zna  0
чартерним	            	adj:m:v_oru 0
частіше	                    adv:compr  6
чесно	                   	adv:compb 9
чи	                        conj:coord:subord 0
чого	                    pron:int:rel:n:v_rod  0
чоловіку	              	noun:m:v_dav:anim  0
чув	                        verb:past:m:imperf  0
чітко	                   	adv:compb  6
щоб                     	conj:subord 0
щодо          	            prep:rv_rod  0
щоп'ятниці	           		adv  0
який	                    adj:m:v_naz:&pron:int:rel:def (conj:subord) 0
якийсь	                  	adj:m:v_naz:&pron:ind 0
яку	                       	adj:f:v_zna:&pron:int:rel:def 0
якщо	                    conj:subord  0
які	                        adj:p:v_naz:&pron:int:rel:def 0
ідіть	                    verb:impr:p:2:imperf  0
із	                        prep:rv_oru 0
імені	                    noun:n:v_rod  0
їй           	            pron:pers:f:3:v_dav:anim  0
її	                        pron:pers:f:3:v_rod:ani 0
