Як	                як                                  part 
погано	               погано                           adv:compb 
коли	               коли                               adv
                                              
відкривають	відкривати                    verb:pres:p:3:imperf 
ресторан 	ресторан                      noun:m:v_zna 
люди	                люди                             noun:p:v_naz:anim 
які	                який                               pron:int:rel:def
                                                      
зовсім	                зовсім                           adv 
нічого	                нічого                            adv 
                                                       
не	               не                                   part 
тямлять	               тямити                           verb:pres:p:3:imperf 
у	               у                                     prep:rv_zna:v-u                
цій	               цей                                 pron:dem                                                     ( pron:dem:f:s:v_zna)                   
                                                                                  
справі	               справа                           noun:f:v_mis 

на	               на                                  prep:rv_zna: 
вигляд	               вигляд                           noun:m:v_naz 
                                                       
схоже	                схожий                           adj:n:v_naz 
                                                      
на	                на                                  prep:rv_zna
посередній	посередній                    adj:m:v_naz 
                                                       
паб	                паб                                 noun:m:v_naz 

першим	                перший                               adj:m:v_oru 
                                                                       
часом	                часом                                  noun:m:v_oru 
там	               там                                       adv 
                                                     
будуть	              бути                                       verb:futr:p:3:imperf 
клієнти	              клієнт                                    noun:p:v_naz:anim 

приходитимуть	приходити                             verb:futr:p:3:imperf 
заради	                заради                                  prep:rv_rod 
цікавості	                цікавість                                noun:f:v_rod 

але	                але                                          conj:coord 
                                                    
я	                я                                              pron:pers:s:1:v_naz:anim 
думаю	               думати                                     verb:pres:s:1:imperf 
що	               що                                             conj:subord 
                                                      
навряд	              навряд                                         adv                                                   навряд чи (part)
чи	              чи                                                 conj:coord:subord                          навряд чи (part)
                                                                                   part 
хтось	              хтось                                            pron:ind:v_naz:anim 
з	              з                                                   prep:rv_rod
клієнтів	              клієнт                                           noun:p:v_rod:anim 
                                                     
повертатиметься	повертатися                              verb:rev:futr:s:3:imperf 
ще	                ще                                               part 
раз	                раз                                             noun:m:v_naz 
                                                     
після	                після                                          adv 
                                                     
свого	                свій                                           pron:pos                                               (pron:pos:m:s:v_rod)     
                                                                                  
першого	               перший                                      adj:m:v_rod                                          (numr:m:s:v_oru)
                                                                                 adj:m:v_zna 
                                                                                 adj:n:v_rod 
візиту	                візит                                        noun:m:v_rod 

А	                  а                                              part 
гардероб	               гардероб                                   noun:m:v_naz 
                                                     
ваш	               ваш                                            pron:pos                                                (pron:pos:m:s:v_rod)
                                                          
де	                де                                             adv
                                                   
що	               що                                              conj:subord 
                                                    
куртки	               куртка                                       noun:f:p:v_naz 
                                                     
на	                на                                             prep:rv_mis 
стільцях	                стілець                                     noun:p:v_mis 
висять	                висіти                                       verb:pres:p:3:imperf 
                                     
Цінам	                 ціна                                            noun:p:v_dav 
має	                 мати                                           verb:pres:s:3:imperf
                                      
відповідати	відповідати                                 verb:inf:imperf 
сервіс	                сервіс                                           noun:m:v_naz 
                                                         
страви	                страва                                          noun:p:v_naz 
                                    
меню                                                                             noun:nv 
                                   
а	                 а                                                  part
                                     
що	                 що                                              pron:int:rel:n:v_naz 
                                                                                   
можна	                 можна                                        predic 
казати	                 казати                                       verb:inf:imperf 
коли	                 коли                                           adv
ці	                 цей                                             pron:dem                                (pron:dem:p:v_naz)
                                              
столи	                стіл                                              noun:p:v_naz
                                               
і	                 і                                                 conj:coord 
                                                
крісла	                крісло                                        noun:p:v_naz 
                                               
напевно	                напевно                                    adv 
на	                на                                              prep:rv_mis 
звалищі	                звалище                                    noun:n:v_mis 
знайшли	                знайти                                       verb:past:p:perf 

столи	                 стіл                                           noun:p:v_naz 
                                               
навіть	                 навіть                                        part 
не	                 не                                              part 
застелені	 застелений                               adjp:pasv:past:p:v_naz 
                                                                                
скатертинами	 скатертина                                noun:p:v_oru 

а	                  а                                                conj:coord 
                                                   
меню	                 меню                                            noun:nv 
                              
взагалі	                 взагалі                                          adv:v-u 
ніякої	                 ніякий                                            pron:neg 
критики	                критика                                          noun:f:v_rod 
                                           
не	                 не                                                  part 
витримує	 витримувати                                verb:pres:s:3:imperf 

ну	                  ну                                                part 
це	                  цей                                              pron:dem                           (pron:dem:n:s:v_naz)
                                           
просто	                 просто                                         adv:compb 
                                           
смішно	                 смішно                                           adv 
З	                  з                                                    prep:rv_oru 
такими	                  такий                                            pron:def                                     (pron:def:p:v_oru)
цінами	                 ціна                                                noun:p:v_oru 
перш	                 перш                                               adv 
за	                 за                                                   prep:rv_rod:rv_zna:rv_oru         перш за все -( conj  )
все	                 весь                                                adv:v-u                                        перш за все -( conj  )
                                           
заклад	                 заклад                                           noun:m:v_naz 
                                           
має	                 мати                                               verb:pres:s:3:imperf 
                                           
мати	                мати                                                 verb:inf:imperf 
                                            
дуже	                 дуже                                                 adv 
                                            
високий	               високий                                               adj:m:v_naz:compb 
                                            
рівень	               рівень                                                  noun:m:v_naz 
                                              
гламуру	                гламур                                                 noun:m:v_rod:slang 
позиції	                позиція                                                noun:p:v_naz 
                                             
в	                 в                                                          prep:rv_mis:v-u 
меню	                меню                                                    noun:n:nv 
                              
мають	                мати                                                     verb:pres:p:3:imperf 
                                     
відповідати	відповідати                                          verb:inf:imperf 
високому 	високий                                                adj:m:v_dav:compb 
                                                         
рівню	                 рівень                                                   noun:m:v_dav 
                                                   
цінам	                 ціна                                                      noun:p:v_dav 
має	                 мати                                                     verb:pres:s:3:imperf 
                                                   
відповідати	відповідати                                          verb:inf:imperf 

сервіс	                 сервіс                                                   noun:m:v_naz 
                                     

посуд	                 посуд                                                    noun:m:v_naz 
                                     
і	                   і                                                            conj:coord 
                                     
А	                а                                                                  part 
про	                про                                                              prep:rv_zna 
картку	                картка                                                         noun:f:v_zna 
знижки	                знижка                                                        noun:p:v_zna 
85%	                85%                                                              number 
просто	                просто                                                         adv:compb 
                                      
смішно	                смішно                                                           adv 
Ну	               ну                                                                     excl 
                           
це	             цей                                                                      pron:dem                (pron:dem:n:s:v_naz)
                         
і	               і                                                                          conj:coord 
                         
туриста	              турист                                                                 noun:m:v_zna:anim 

і	             і                                                                             conj:coord 
                               
гостя	            гість                                                                       noun:m:v_zna:anim 
міста	            місто                                                                      noun:p:v_zna 
Лева	            Лев                                                                        noun:m:v_zna:anim:fname
                                     
Розробники	розробник                                                        noun:p:v_naz:anim 
постаралися	постаратися                                                     verb:rev:past:p:perf 
концепт	                концепт                                                              noun:m:v_naz 
                                                       
на	               на                                                                          prep:rv_mis 
висоті	               висота                                                                   noun:f:v_mis 
Тут	              тут                                                                           adv
є	              бути                                                                         verb:pres:p:3:imperf 
                          
те	              той                                                                           pron:dem                            ( pron:dem:n:s:v_naz)

чого	                що                                                                          pron:int:rel:n:v_rod 
бракує	                бракувати                                                             verb:pres:s:3:imperf    
80%	                80%                                                                         number 
Львова	                 Львів                                                                     noun:m:v_rod 

ЧУДОВА	                чудовий                                                                 adj:f:v_naz:compb 
АТМОСФЕРА	атмосфера                                                            noun:f:v_naz 

Кухня	                   кухня                                                                   noun:f:v_naz 
на	                  на                                                                         prep:rv_mis 
мій	                  мій                                                                        pron:pos                             (pron:pos:m:s:v_naz)
                              
вибагливий	вибагливий                                                           adj:m:v_naz:compb 
                                                       
смак	                 смак                                                                      noun:m:v_naz 

середня	                середній                                                                 adj:f:v_naz 
але	                але                                                                          conj:coord 
                                                       
зі	                зі                                                                            prep:rv_oru
скидкою	               скидка                                                                     noun:f:v_oru:bad 
90%	               90%                                                                           number 
вона	               вона                                                                         pron:pers:f:3:v_naz:anim 
і	               і                                                                                conj:coord 
                                                       
відносно	              відносно                                                                    adv 
недорога               недорогий                                                                 adj:f:v_naz 
Тобто	                   тобто                                                                     conj:subord 
                            
красиво	                   красиво                                                                   adv:compb 
поїсти	                   поїсти                                                                      verb:inf:perf 
з	                  з                                                                               prep:rv_oru
хорошою	                  хороший                                                                   adj:f:v_oru:compb 
музикою	                 музика                                                                      noun:f:v_oru 

вином	                   вино                                                                         noun:n:v_oru 

це	                  цей                                                                           adj:n:v_naz:&pron:dem               (part)
                                                                                                                   adj:n:v_zna:&pron:dem 
сюди	                 сюди                                                                          adv 

Сервіс	                 сервіс                                                                       noun:m:v_naz 
                                
всі	                 весь                                                                          pron:dem                                        (pron:dem:p:v_naz)
                                
рази	                 раз                                                                            noun:p:v_naz 
                                  
що	                 що                                                                              pron:int:rel:n:v_naz 
                                  
я	                   я                                                                               pron:pers:s:1:v_naz:anim
була	                  бути                                                                             verb:past:f:imperf 
або	                 або                                                                            conj:coord 
хороший	                хороший                                                                     adj:m:v_naz:compb 
або	                     або                                                                       conj:coord 
в	                     в                                                                           prep:rv_mis:v-u 
крайньому	     крайній                                                                 adj:m:v_mis 
                                                
разі	                    раз                                                                         noun:m:v_mis 
Сюди	                      сюди                                                                      adv
не	                      не                                                                          part 
соромно	                     соромно                                                                 adv 
привести	                     привести                                                                verb:inf:perf 
людину	                     людина                                                                   noun:f:v_zna:anim 

яку	                     який                                                                   noun:m:v_dav:anim                              (pron: питальний займенник, від слова який)
                                                                                                                noun:m:v_mis:anim 
                                                                                                                adj:f:v_zna:&pron:int:rel:def
любиш	                    любити                                                                verb:pres:s:2:imperf 
або	                    або                                                                       conj:coord 
поважаєш	    поважати                                                              verb:pres:s:2:imperf 
Клозет	                      клозет                                                                   noun:m:v_naz 
                                 
взагалі	                     взагалі                                                                    adv:v-u 
                                                                                                                                 
у	                     у                                                                              prep:rv_mis
місті	                    місто                                                                        noun:n:v_mis 

Єдине	                  єдиний                                                                        adj:n:v_naz                                          
                                                                                                                      adj:n:v_naz
що	                  що                                                                                conj:subord                                 
                               
народу	                 народ                                                                           noun:m:v_rod 
переважно	 переважно                                                                   adv 
багато	                 багато                                                                          adv 
                                                    
тому	                 тому                                                                               conj:subord 
                                             
погано	                 погано                                                                            adv:compb 
що	                 що                                                                                   conj:subord 
                                             
він	                 він                                                                                   pron:pers:m:3:v_naz:anim
один	                 один                                                                                numr:m:v_naz 
                                          
Молодці	                  молодець                                                                        noun:p:v_naz:anim 
                                                
бажаю	                   бажати                                                                            verb:pres:s:1:imperf 
Вам	                   ви                                                                                    pron:pers:p:2:v_dav:anim
процвітання	   процвітання                                                                    noun:n:v_zna 
                                                     

і	                      і                                                                                     conj:coord 
                                                     
тримати	                   тримати                                                                           verb:inf:imperf 
марку	                   марка                                                                               noun:f:v_zna 
Ой	                     ой                                                                                     excl 
з	                     з                                                                                       prep:rv_rod
попереднього	     попередній                                                                      adj:n:v_rod 
                                                          
повідомлення	      повідомлення                                                                 noun:n:v_naz 
                                                           
в	                      в                                                                                       prep:rv_mis
частині	                      частина                                                                            noun:f:v_mis 
ціни	                      ціна                        
                                                                                                                                 noun:f:v_rod 
власне	                     власне                                                                                insert 
                                                              
всі	                     весь                                                                                    pron:dem 
                                                              
ціни	                     ціна                                                                                     noun:p:v_naz 
                                                             
там	                      там                                                                                     adv 
                                                               
слід	                      слід                                                                                     predic 
ділити	                      ділити                                                                                 verb:inf:imperf 
на	                      на                                                                                        prep:rv_znа
10	                      10                                                                                        number 
але	                     але                                                                                      conj:coord 
                                      
для	                     для                                                                                       prep:rv_rod 
цього	                     цей                                                                                       pron:dem                           (pron:dem:m:s:v_rod)
                                        
перед	                     перед                                                                                   noun:m:v_naz                    ( prep:rv_oru)
                                                                                                                                  noun:m:v_zna 
тим	                     той                                                                                       pron:dem                            (pron:dem:m:s:v_oru)
                                         
слід	                     слід                                                                                      predic 
взяти	                     взяти                                                                                   verb:inf:perf 
знижку	                     знижка                                                                                 noun:f:v_zna 

сказавши	                      сказати                                                                               advp:perf 
кодові	                      кодовий                                                                               adj:p:v_zna 
                                 
слова	                       слово                                                                                 noun:p:v_zna 
і	                        і                                                                                         conj:coord 
                                
не	                       не                                                                                       part 
у	                        у                                                                                        prep:rv_zna
офіціантів	        офіціант                                                                            noun:p:v_zna:anim 
ресторану	        ресторан                                                                           noun:s:v_zna 
перед	                        перед                                                                                noun:m:v_naz                                ( prep:rv_oru)
                                                                                                                                  noun:m:v_zna 
оплатою	                        оплата                                                                              noun:f:v_oru 
а	                       а                                                                                         conj:coord 
                                     
значно	                     значно                                                                                 adv:compb 
раніше	                     раніше                                                                                  adv 
                                   
З	                       з                                                                                     prep:rv_rod
нашої	                       наш                                                                                 pron:pos 
компанії	                       компанія                                                                         noun:f:v_rod 
                                
в	                       в                                                                                     prep:rv_zna:rv_mis:rv_rod:v-u 
жодної	                       жодний                                                                           pron 
людини	                      людина                                                                            noun:f:v_rod:anim 
не	                      не                                                                                    part 
переплутали	      переплутати                                                                   verb:past:p:perf 
замовлення	      замовлення                                                                      noun:n:v_zna 
                                                          
Кухня	                       кухня                                                                                noun:f:v_naz 
дуже	                       дуже                                                                                 adv 

смачна	                       смачний                                                                           adj:f:v_naz:compb 
Обслуговування	      обслуговування                                                              noun:n:v_naz 
                                                                 
на	                      на                                                                                     prep:rv_mis 
найвищому	      високий                                                                            adj:m:v_mis:super 
                                                               
рівні	                      рівень                                                                               noun:m:v_mis 
                                                               
Всім	                      весь                                                                                  pron:dem                                     (pron:dem:p:v_dav)
                                                             
рекомендую	    рекомендувати                                                                  verb:pres:s:1:imperf 

Випадково	     випадково                                                                          adv 
попали	                     попасти                                                                              verb:past:p:perf 
до	                     до                                                                                        prep:rv_rod 
масонів	                     масон                                                                                   noun:p:v_rod:anim 
                                                          
перед	                     перед                                                                                  noun:m:v_naz 
                                                                                                                                 noun:m:v_zna                                                    ( prep:rv_oru)
футболом	    футбол                                                                                 noun:m:v_oru 
По-перше	    по-перше                                                                                adv 
                                                  
нас	                     ми                                                                                           pron:pers:p:1:v_zna:anim
                                                 
ніхто	                     ніхто                                                                                        pron:neg:v_naz:anim 
не	                     не                                                                                            part 
попереджав	    попереджати                                                                           verb:past:m:imperf                                
про	                    про                                                                                           prep:rv_zna 
таємний	                    таємний                                                                                   adj:m:v_zna 
вхід	                    вхід                                                                                           noun:m:v_zna 
і	                     і                                                                                                conj:coord 
                                                     
ціни	                    ціна                                                                                           noun:p:v_zna 
з	                    з                                                                                                prep:rv_oru
             
ключиками	   ключик                                                                                        noun:p:v_oru 
і	                    і                                                                                                  conj:coord 
                                                     
картками	                   картка                                                                                          noun:p:v_oru 

Коли	                 коли                                                                                              adv
                          
той	                 той                                                                                               pron:dem                              (pron:dem:m:s:v_naz)
                         
дядько	                 дядько                                                                                         noun:m:v_naz:anim 
в	                 в                                                                                                  prep:rv_mis:v-u 
сінцях	                 сінці                                                                                             noun:p:v_mis 
в	                 в                                                                                                  prep:rv_mis::v-u 
капцях                      капець                                                                                         noun:p:v_mis 
на	                 на                                                                                                prep:rv_zna:rv_mis 
босу	                 босий                                                                                           adj:f:v_zna 

ногу	                 нога                                                                                             noun:f:v_zna 
на	                 на                                                                                                prep:rv_zna 
запитання	запитання                                                                                    noun:n:v_zna 
                                                      
про	                про                                                                                                prep:rv_zna 
попоїсти	                попоїсти                                                                                        verb:inf:perf 
запропонував	запропонувати                                                                             verb:past:m:perf 
нам	                 ми                                                                                                  pron:pers:p:1:v_dav:anim 
позавчорашні	позавчорашній                                                                              adj:p:v_zna 
голубці	                 голубець                                                                                     noun:p:v_zna 
                                             
а	                      а                                                                                               conj:coord 
                                                   
зрештою	                    зрештою                                                                                     adv 
                                                   
впустив	                    впустити                                                                                    verb:past:m:perf:v-u 
власне	                    власне                                                                                        insert 
                                                     

                           
до	                     до                                                                                                prep:rv_rod 
ресторації	     ресторація                                                                                  noun:f:v_rod 
                                                    
ми	                      ми                                                                                              pron:pers:p:1:v_naz:anim 
ледь	                      ледь                                                                                           adv 
                                                
зі	                       зі                                                                                               prep:rv_rod 
сміху	                       сміх                                                                                            noun:m:v_rod 
не	                        не                                                                                             part 
Сміх	                         сміх                                                                                        noun:m:v_naz 
                          
пропав	                        пропасти                                                                                verb:past:m:perf 
коли	                        коли                                                                                        adv 
                         

принесли 	        принести                                                                                verb:past:p:perf 
меню	                        меню                                                                                       noun:nv 
                              
Всі	                         весь                                                                                          pron:dem                                          (pron:dem:p:v_naz)
                            
повставали	         повставати                                                                              verb:past:p:imperf 
і	                         і                                                                                                 conj:coord 
                                                        
хотіли	                         хотіти                                                                                         verb:unknown                                      ( verb: past:p:imperf)
йти	                         йти                                                                                             verb:inf:imperf 
Про	                        про                                                                                               prep:rv_zna 
якісь	                        якийсь                                                                                          pron:ind 
картки	                        картка                                                                                          noun:p:v_zna 
ми	                        ми                                                                                                 pron:pers:p:1:v_naz:anim
нічого	                        ніщо                                                                                              pron:neg:v_rod 
                             
не	                       не                                                                                                  part 
знали	                       знати                                                                                             verb:past:p:imperf 
і	                      і                                                                                                       conj:coord 
                               
хотіли	                      хотіти                                                                                              verb:unknown                                  ( verb: past:p:imperf)
вже	                      вже                                                                                                  adv:v-u 
послати                        послати                                                                                           verb:inf:perf 
на	                      на                                                                                                     prep:rv_mis 

цих	                      цей                                                                                                   pron:dem                                          (pron:dem:p:v_rod)  
                               
придурків	     придурок                                                                                          noun:p:v_zna:anim 
з	                     з                                                                                                        prep:rv_oru
їхнім	                    їхній                                                                                                    pron:pos 
                                         
за	                     за                                                                                                       prep:rv_rod
Але	                      але                                                                                                     conj:coord 
                                        
наш	                      наш                                                                                                     pron:pos                                         (pron:pos:m:s:v_naz)
                                                                                                                                                                                                         (noun:m:s:v_naz
зрештою	                      зрештою                                                                                              insert 
що	                       що                                                                                                       conj:subord 
                                        
це	                       цей                                                                                                      pron:dem                                       (pron:dem:n:s:v_naz) 
                                         
жарт	                       жарт                                                                                                    noun:m:v_naz 
                                        
і	                       і                                                                                                           conj:coord 
                                        
запропонував	       запропонувати                                                                                 verb:past:m:perf 
відкинути	       відкинути                                                                                           verb:inf:perf 
по	                       по                                                                                                       prep:rv_mis
останньому	       останній                                                                                             adj:m:v_mis 
                                                                 
нулі	                        нуль                                                                                                   noun:m:v_mis 
                                                
від	                        від                                                                                                       prep:rv_rod 
ціни	                        ціна                                                                                                     noun:f:v_rod 
                                              
то	                        то                                                                                                         conj:subord 
і	                         і                                                                                                           conj:coord 
                                           
буде	                        бути                                                                                                     verb:futr:s:3:imperf 
дійсна	                        дійсний                                                                                                 adj:f:v_naz 
ціна	                        ціна                                                                                                       noun:f:v_naz 
Пили	                              пити                                                                                               verb:past:p:imperf 
пиво	                              пиво                                                                                               noun:n:v_zna 
наші	                             наша                                                                                                 pron:pos                                      ( pron:pos:p:v_naz)
                               
пацани	                            пацан                                                                                                noun:p:v_naz:anim 
штук	                            штука                                                                                                noun:p:v_rod 
по	                            по                                                                                                      prep:rv_zna 
два	                            два                                                                                                    numr:m:v_zna 
                             
потім	                            потім                                                                                                  adv
молочні	                            молочний                                                                                           adj:p:v_naz 
                                           
коктейлі	                             коктейль                                                                                           noun:p:v_naz 
                                 
А	                                 а                                                                                       part 
ми	                                 ми                                                                                     pron:pers:p:1:v_naz:anim
взяли	                                 взяти                                                                                verb:past:p:perf 
до	                                 до                                                                                      prep:rv_rod 
їжі	                                 їжа                                                                                      noun:f:v_rod 
досить	                                 досить                                                                                adv 
                             
пристойну	                 пристойний                                                                        adj:f:v_zna 
власну	                                 власний                                                                              adj:f:v_zna 
Всі	                                весь                                                                                   pron:dem                                                     (pron:dem:p:v_naz)
                           
їли	                                їсти                                                                                    verb:past:p:imperf 
супи	                                суп                                                                                     noun:p:v_zna 

3-4	                                 3-4                                                                                     number 
види	                                 вид                                                                                    noun:p:v_naz 
                               
і	                              і                                                                                conj:coord 
                                   
багато	                              багато                                                                      numr:p:v_naz
                                  
овочів	                               овоч                                                                          noun:p:v_zna
гриль	                               гриль                                                                         noun:m:v_zna 

незвичайний	                незвичайний                                                            adj:m:v_zna 
житній	                                житній                                                                        adj:m:v_zna 
хліб	                                хліб                                                                             noun:m:v_zna 
Особливо	                  особливо                                                                  adv 
пішли	                                  піти                                                                           verb:past:p:perf 
біфштекси	                  біфштекс                                                                   noun:p:v_zna 
з	                                  з                                                                               prep:rv_oru
кров	                                 кров                                                                          noun:f:v_naz                                         кров - (noun:f:s:v_oru)
                                                                                                                                   noun:f:v_zna 
Нас	                                     ми                                                                  pron:pers:p:1:v_zna:anim
шестеро	                                     шість                                                              numr:p:v_zna 
наїлися	                                    наїстися                                                         verb:rev:past:p:perf 
з	                                    з                                                                     prep:rv_rod
дороги	                                    дорога                                                            noun:f:v_rod 
                                
щільно	                                     щільно                                                             adv:compb 
і	                                      і                                                                      conj:coord 
                                 
смачно	                                   смачно                                                               adv:compb 
Заплатили	                   заплатити                                                       verb:past:p:perf  
за	                                   за                                                                     prep:rv_zna
все	                                   весь                                                                 pron:dem 
                               
860	                                   860                                                                   number 
гривень	                                   гривня                                                              noun:p:v_rod 
Так	                                 так                                                                       adv
що	                                 що                                                                       pron:int:rel:n:v_naz 
                                   
хай	                                 хай                                                                      part 
прикольна	               прикольний                                                         adj:f:v_naz                                                       
найдорожча	               дорогий                                                               adj:f:v_naz:super                                             
ресторація                            ресторація                                                          noun:f:v_naz                                                  
Взагалі	                                 взагалі                                                                adv:v-u 
я	                                 я                                                                           pron:pers:s:1:v_naz:anim
ще	                                ще                                                                          adv 
                                      
не	                                не                                                                           part 
була	                                бути                                                                       verb:past:f:imperf 
але	                                 але                                                                         conj:coord 
                                    
сподіваюся	                сподіватися                                                            verb:rev:pres:s:1:imperf 
ближчим	                                близький                                                                 adj:n:v_oru:compr                                           (adj:m:v_oru:compr)
                                                                                                                                 adj:p:v_dav:compr 
часом	                                 час                                                                           noun:m:v_oru 
туди	                                 туди                                                                         adv
потрапити	                 потрапити                                                               verb:inf:perf 
Проте	                                 проте                                                                          insert 
хочу	                                 хотіти                                                                          verb:unknown                                              (verb: pres:s:1:imperf)
сказати	                                 сказати                                                                       verb:inf:perf 
що	                                  що                                                                               conj:subord 
                                        
для	                                  для                                                                              prep:rv_rod 
масонів	                                 масон                                                                           noun:p:v_rod:anim 
                                        
гроші	                                гроші                                                                              noun:p:v_naz 
це	                                 цей                                                                                pron:dem                                             (pron:dem:n:s:v_naz)
                                       
спосіб	                                 спосіб                                                                            noun:m:v_naz 
                                     
а	                                  а                                                                                      conj:coord 
                                    
не	                                  не                                                                                    part 
мета                              	  мета                                                                                noun:f:v_naz 

тому	                                тому                                                                                   conj:subord 

той                                            той                                                                                     pron:dem 
їм	                                  вони                                                                                   pron:pers:p:3:v_dav:anim
усе	                                  усе                                                                                      adv:v-u                                                  (усе одно - adv) 
                                                                                                                                              conj:coord:v-u 
                                                                                                                                              part:v-u 
одно	                                  один                                                                                    numr:n:v_naz                                        (усе одно - adv )

чи	                                 чи                                                                                          conj:subord 
                            
заплатять	                 заплатити                                                                             verb:futr:p:3:perf 
вони	                                 вони                                                                                      pron:pers:p:3:v_naz:anim
зараз	                                 зараз                                                                                    adv 

1	                                  1                                                                                            number 

чи	                                 чи                                                                                        conj:subord 
                                       
півмільйона	                півмільйона                                                                           noun:m:v_zna:nv:np 

Та	                               та                                                                                         conj:coord 
                                  
навіть	                               навіть                                                                                    part 
будь-яка	                               будь-який                                                                              pron:ind 
людина	                               людина                                                                                  noun:f:v_naz:anim 
залишившись	               залишитися                                                                            advp:rev:perf 

на	                                на                                                                                           prep:rv_mis 
безлюдному	                безлюдний                                                                             adj:m:v_mis 
                                                      
острові	                                острів                                                                                      noun:m:v_mis 

віддасть	                                 віддати                                                                                   verb:futr:s:3:perf 
усі	                                  увесь                                                                                      pron:dem
                                                                                                                                                 
свої	                                   свій                                                                                        pron:pos 
                                                     
папірці	                                   папірець                                                                                 noun:p:v_zna 
заради	                                   заради                                                                                   prep:rv_rod 
ложки	                                   ложка                                                                                     noun:f:v_rod 
                                             
супу	                                   суп                                                                                          noun:m:v_rod 
чи	                                   чи                                                                                            conj:subord 
                                        
простого	                                  простий                                                                                   adj:m:v_rod:compb 
                                       
ножа	                                  ніж                                                                                           noun:m:v_rod 
Ціни	                                ціна                                                                                         noun:p:v_naz 
                                      
це	                                цей                                                                                          pron:dem                                       (pron:dem:n:s:v_naz)
                                       
й	                                й                                                                                              part 
підкреслюють	               підкреслювати                                                                        verb:pres:p:3:imperf 
Гроші	                                гроші                                                                                      noun:p:v_naz 
                                  

це	                                цей                                                                                          pron:dem                                          (pron:dem:n:s:v_naz)
                                  
спосіб	                               спосіб                                                                                       noun:m:v_naz 

Про	                                 про                                                                                        prep:rv_zna 
символи	                                 символ                                                                                  noun:p:v_zna 
і	                                 і                                                                                              conj:coord 
таке	                                 такий                                                                                     adj:n:v_naz:&pron:def                         (pron:dem)                               
                                                                                                                                                pron:def 
інше	                                 інший                                                                                      
так	                                так                                                                                           adv 
                                    
як	                                 як                                                                                            adv
                                   
і	                                  і                                                                                               part 
в	                                 в                                                                                              prep:rv_mis:
є	                                бути                                                                                         verb:pres:s:1:imperf 
                                   
хрест	                               хрест                                                                                         noun:m:v_naz                                        (noun:m:s:v_naz)          
                                  
біблія	                              біблія                                                                                           noun:f:v_naz                                        (noun:f:s:v_naz )
і	                               і                                                                                                   conj:coord 
                                       
ікона	                              ікона                                                                                           noun:f:v_naz                                         (noun:f:s:v_naz )

до речі                               до речі                                                                                                 <insert> 

                         
 якщо                                   якщо                                                                                                     conj:subord 
вірити	                         вірити                                                                                                    verb:inf:imperf 
то	                         то                                                                                                            conj:subord 
головний	                         головний                                                                                                 adj:m:v_naz:compb 
                                 
символ	                         символ                                                                                                    noun:m:v_naz 
                                
масонів	                         масон                                                                                                       noun:p:v_rod:anim 
                                  
має	                         мати                                                                                                          verb:pres:s:3:imperf 
                                      

схожість                	          схожість                                                                                                     noun:f:v_zna                               (noun:f:s:v_zna )
з	                          з                                                                                                                 prep:rv_oru
християнськими	          християнський                                                                                            adj:p:v_oru 
 
символами	          символ                                                                                                         noun:p:v_oru 

А	                             а                                                                                                                     part 
головне	                             головний                                                                                                       adj:n:v_naz:compb 
                                      
що	                             що                                                                                                                  conj:subord 
                                     
масони	                            масон                                                                                                              noun:p:v_naz:anim 
не	                            не                                                                                                                    part 
забороняють	           забороняти                                                                                                     verb:pres:p:3:imperf 
вірити	                           вірити                                                                                                              verb:inf:imperf 
у	                           у                                                                                                                       prep:rv_zna 
те	                           той                                                                                                                    pron:dem                                       (pron:dem:n:s)
                                                      
що	                          що                                                                                                                       pron:int:rel:n:v_naz 
                                                
ти	                          ти                                                                                                                        pron:pers:s:2:v_naz:anim 
                                                 
віриш	                            вірити                                                                                                             verb:pres:s:2:imperf 
Серед	                             серед                                                                                                        prep:rv_rod
 
них	                              вони                                                                                                         pron:pers:p:3:v_rod:anim
                             
є	                             бути                                                                                                           verb:pres:p:1:imperf 
                               
багато	                             багато                                                                                                        numr:p:v_naz
                              
і	                              і                                                                                                                 conj:coord 
                              
православних	              православний                                                                                          adj:p:v_zna 
                                                             
і	                                і                                                                                                               conj:coord 
                                                   
ні	                             ні                                                                                                                 part 
,	- 
- 
навіть	                             навіть                                                                                                          part 
і	                               і                                                                                                                  conj:coord 
                                                    
сатаністи 	               сатаніст                                                                                                    noun:p:v_naz:anim 
                                                    
можуть             	              могти                                                                                                          verb:unknown                               ( verb:pres:p:3:imperf)
бути	                              бути                                                                                                            verb:inf:imperf 

це	                               цей                                                                                                              pron:dem                                      ( pron:dem:n:s)
                                              
окремий	                              окремий                                                                                                       adj:m:v_naz                                  ( adj:m:s:v_naz)
                                            
вибір	                              вибір                                                                                                            noun:m:v_naz                                ( noun:m:s:v_naz) 
                                             
людини	                               людина                                                                                                        noun:f:v_rod:anim                        (noun:f:s:v_rod:anim )
були	                               бути                                                                                                           verb:past:p:imperf                          
в	                               в                                                                                                                 prep:rv_mis
цьому	                               цей                                                                                                             pron:dem                                          ( pron:dem:m:s:v_mis)


легендарному	               легендарний                                                                                             adj:m:v_mis                                      (adj:m:s:v_mis) 
                                                         
закладі	                              заклад                                                                                                        noun:m:v_mis                                   (noun:m:s:v_mis)

якщо	                                  якщо                                                                                                     conj:subord 
сказати	                                  сказати                                                                                                verb:inf:perf 
по	                                  по                                                                                                         prep:rv_mis
правді	                                  правда                                                                                                 noun:f:v_mis 
спочатку	                                  спочатку                                                                                              adv 
враження	                  враження                                                                                              noun:p:v_naz 
                                                     
позитивні	                   позитивний                                                                                         adj:p:v_naz:compb 
                                                         
аж	                                   аж                                                                                                         conj:subord 
                                    
доки	                                   доки                                                                                                      conj:subord 
не	                                   не                                                                                                          part 
принесли	                                   принести                                                                                              verb:past:p:perf 
перші	                                   перший                                                                                                 adj:p:v_zna 
страви	                                   страва                                                                                                  noun:p:v_zna 

на мою думку                          на мою думку                                                                                        </insert> 
це	                                 цей                                                                                                         pron:dem                                    ( pron:dem:n:s:v_naz)
                          
один	                                 один                                                                                                        numr:m:v_naz 
                           
з	                                з                                                                                                               prep:rv_rod
найгірших	                поганий                                                                                                   adj:p:v_rod:super 
                                                 
закладів	                                заклад                                                                                                      noun:p:v_rod 
ЛОКАЛЬ	                                локаль                                                                                                      noun:f:v_naz                             (noun:n:v_rod) 
за	                                за                                                                                                         prep:rv_zna
таку	                               такий                                                                                                     pron:def 
таку	                               такий                                                                                                     pron:def 
і	                               і                                                                                                              conj:coord 
                                      
з	                              з                                                                                                             prep:rv_oru
таким	                             такий                                                                                                       pron:def 
                                       
ніяким	                             ніякий                                                                                                      pron:neg                                        (pron:neg:s:m:v_oru)
                                       
смаком	                              смак                                                                                                        noun:m:v_oru                                 (noun:m:s:v_oru) 
мені	                              я                                                                                                               pron:pers:s:1:v_dav:anim 
                                     
ще	                             ще                                                                                                            part 
ніхто	                             ніхто                                                                                                        pron:neg:v_naz:anim 
не	                             не                                                                                                            part 
подавав	                             подавати                                                                                                verb:past:m:imperf 
ще	                               ще                                                                                                      part 
й	                               й                                                                                                        part 
за	                               за                                                                                                                                                             ( prep:v_zna)

фірмову	                              фірмовий                                                                                            adj:f:v_zna                                    (adj:f:s:v_zna)
страву	                              страва                                                                                                noun:f:v_zna                                 (noun:f:s:v_zna) 
дня	                              день                                                                                                    noun:m:v_rod                               (noun:m:s:v_rod )
взяли	                              взяти                                                                                                  verb:past:p:perf 
чомусь	                             чомусь                                                                                                 adv

подвійну	                             подвійний                                                                                             adj:f:v_zna 
ціну	                             ціна                                                                                                       noun:f:v_zna                                (noun:f:s:v_zna )
нікому	                                ніхто                                                                                                  pron:neg:v_dav:anim 
не	                                не                                                                                                      part 
раджу	                                радити                                                                                              verb:pres:s:1:imperf 
приходити	                приходити                                                                                         verb:inf:imperf 
в	                                в                                                                                                         prep:rv_zna 
цей	                               цей                                                                                                       pron:dem                                         ( pron:dem:m:s:v_zna)
                                             
заклад	                               заклад                                                                                                 noun:m:v_zna                                  ( noun:m: s:v_zna)
                                              
хіба	                                хіба                                                                                                        conj:subord 
                           
що	                                що                                                                                                          conj:subord 
                          
просто	                                просто                                                                                                   adv:compb 
                             
подивитись	                подивитися                                                                                           verb:rev:inf:perf 
в	                                  в                                                                                                       prep:rv_mis
принципі	                                  принцип                                                                                           noun:m:v_mis 
інтер'єр                    	  інтер'єр                                                                                            noun:m:v_naz                                    (noun:m:s:v_naz)
                                    
дійсно	                                 дійсно                                                                                                 adv 
цікавий	                                 цікавий                                                                                               adj:m:v_naz:compb 
але	                                 але                                                                                                     conj:coord 
                              
не	                                 не                                                                                                       part 
кухня	                                 кухня                                                                                                  noun:f:v_naz                                      ( noun:f:s:v_naz )
доброго	                                добрий                                                                                              adj:m:v_rod:compb 
                                  
дня	                                день                                                                                                  noun:m:v_rod                                     ( noun:m:s:v_rod)
побували	               побувати                                                                                           verb:past:p:perf 
в	                               в                                                                                                         prep:rv_mis
там	                               там                                                                                                     adv  

як	                                 як                                                                                                      adv 
                       
на	                                 на                                                                                                     prep:rv_zna
мене	                                 я                                                                                                       pron:pers:s:1:v_zna:anim 
                                                                                                                                                           
неймовірна	                 неймовірний                                                                                     adj:f:v_naz:compb 
атмосфера	                 атмосфера                                                                                        noun:f:v_naz                                               (noun:f:s:v_naz)
цього	                                 цей                                                                                                     pron:dem                                                    ( pron:dem:m:s:v_rod)
                                                          
закладу	                                 заклад                                                                                                noun:m:v_rod                                            ( noun:m:s:v_rod)
дає	                                давати                                                                                                 verb:pres:s:3:imperf 
поглибитись	                поглибитися                                                                                         verb:rev:inf:perf 
в	                                в                                                                                                            prep:rv_zna:v-u 
середньовіччя	                середньовіччя                                                                                      noun:n:v_zna 
не	                               не                                                                                                          part 
знаю	                               знати                                                                                                    verb:pres:s:1:imperf 
як	                               як                                                                                                           adv
кому	                               хто                                                                                                          pron:int:rel:m:v_dav:anim 
щастить	                               щастити                                                                                                 verb:pres:s:3:imperf 
але	                               але                                                                                                         conj:coord 
                                               
обслуговування	               обслуговування                                                                                     noun:n:v_naz 
                                                               
було	                               бути                                                                                                      verb:past:n:imperf 
на	                               на                                                                                                          prep:rv_mis 
вищому	                               високий                                                                                                adj:n:v_mis:compr 
                                                 
рівні	                                рівень                                                                                                  noun:m:v_mis                                            ( noun:m:s:v_mis) 
і	                                 і                                                                                                           conj:coord 
                        
взагалі	                                взагалі                                                                                                  adv:v-u 
було	                                бути                                                                                                       verb:past:n:imperf 
враження	                враження                                                                                               noun:n:v_naz 
                                                    
що	                                що                                                                                                           pron:int:rel:n:v_naz 
                                        
ти	                                ти                                                                                                            pron:pers:s:2:v_naz:anim 
                                       
якась	                                 якийсь                                                                                                      pron:ind                                              ( pron:ind:f:s:v_naz)
особа	                                 особа                                                                                                       noun:f:v_naz:anim                             ( noun:f: s:v_naz:anim) 
такого	                                такий                                                                                                           pron:def 
                                           
догляду	                               догляд                                                                                                           noun:m:v_rod 
не	                               не                                                                                                                   part 
бачила	                               бачити                                                                                                           verb:past:f:imperf 
ніколи	                                ніколи                                                                                                           adv
не	                                не                                                                                                                  part 
встигнеш	                                встигнути                                                                                                     verb:futr:s:2:perf:v-u 
                                                   
покласти	                                покласти                                                                                                       verb:inf:perf 
в	                                в                                                                                                                    prep:rv_zna 
бік	                                бік                                                                                                                  noun:m:v_zna
                                                  
брудну	                                брудний                                                                                                        adj:f:v_zna:compb 
серветку	                                серветка                                                                                                       noun:f:v_zna                                     (noun:f:s:v_zna) 
як	                                як                                                                                                                     conj:subord 
                                   
її	                                вона                                                                                                                pron:pers:f:3:v_zna:anim 
                                  
тут	                                тут                                                                                                                   adv  
же	                                же                                                                                                                     part 
прибирають	                прибирати                                                                                                        verb:pres:p:3:imperf 
все	                               весь                                                                                                                   adv:v-u 
                           
тонко	                              тонко                                                                                                                  adv:compb 
лаконічно	              лаконічно                                                                                                             adv:compb 
і	                               і                                                                                                                           conj:coord 
                                                   
приємні	                              приємний                                                                                                             adj:p:v_naz:compb 
                                                  
хлопці	                              хлопець                                                                                                                noun:p:v_naz:anim 
                                      
там	                             там                                                                                                                         adv 
                                       
працюють	            працювати                                                                                                             verb:pres:p:3:imperf 
Дуже	                              дуже                                                                                                                      adv

смачно	                             смачно                                                                                                                  adv:compb 
і	                             і                                                                                                                             conj:coord 
                              
приємно	                            приємно                                                                                                                 adv:compb 
було	                            бути                                                                                                                        verb:past:n:imperf 
,	- 
-  
враження	           враження                                                                                                               noun:p:v_naz 
                                                 
найпозитивніші	           позитивний                                                                                                            adj:p:v_naz:super 
                                                       
ой	                          ой                                                                                                                           excl 
як	                         як                                                                                                                             adv
                        
це	                        цей                                                                                                                            pron:dem                                       ( pron:dem:s:n:v_naz)
                          
все	                        весь                                                                                                                           adv:v-u 
                           
по-нашому	         по-нашому                                                                                                                adv 
по-українськи	         по-українськи                                                                                                           adv 
головне	                          головний                                                                                                                adj:n:v_naz:compb 
                                   
покритикувати	          покритикувати                                                                                                       verb:inf:perf 
полити	                           полити                                                                                                                   verb:inf:perf 
брудом	                           бруд                                                                                                                       noun:m:v_oru 
а	                            а                                                                                                                             conj:coord 
                         
от	                            от                                                                                                                            part 
самому	                            самий                                                                                                                      pron:def                                     (pron:def :s:m:v_dav)
                           
щось	                            щось                                                                                                                         pron:ind:n:v_zna 
придумати	            придумати                                                                                                               verb:inf:perf 
зась	                            зась                                                                                                                          excl 
не	                              не                                                                                                                             part 
подобається	              подобатися                                                                                                              verb:rev:pres:s:3:imperf
не	                               не                                                                                                                             part 
ходіть	                               ходити                                                                                                                      verb:impr:p:2:imperf 
туди	                               туди                                                                                                                         adv 
але	                               але                                                                                                                         conj:coord 
                                                         
факт	                               факт                                                                                                                        noun:m:v_naz                             (noun:m:s:v_naz)
                                                         
залишається	               залишатися                                                                                                             verb:rev:pres:s:3:imperf
фактом	                               факт                                                                                                                         noun:m:v_oru                            (noun:m:s:v_naz)
усі	                                увесь                                                                                                                      pron:dem                                    (pron:dem:p:v_naz)
                                          
заклади	                               заклад                                                                                                                 noun:p:v_naz 
                                           
Фесту	                               фест                                                                                                                    noun:m:v_rod:bad 
                                           
користуються	               користуватися                                                                                                    verb:rev:pres:p:3:imperf
величезною	               величезний                                                                                                         adj:f:v_oru 
популярністю	               популярність                                                                                                       noun:f:v_oru 
вечорами	               вечір                                                                                                                    noun:p:v_oru                                 (adv:bad)
і	                                і                                                                                                                           conj:coord 
                                                            
на	                               на                                                                                                                        prep:rv_zna 
вихідні	                              вихідний                                                                                                               noun:p:v_zna 
там	                              там                                                                                                                       adv
                                       
нема	                               нема                                                                                                                   predic 
де	                               де                                                                                                                       adv  
                                       
яблуку	                              яблуко                                                                                                                noun:n:v_dav 
                                     
впасти	                              впасти                                                                                                                verb:inf:perf:v-u 
туристам	                              турист                                                                                                              noun:p:v_dav:anim 
і	                               і                                                                                                                        conj:coord 
                                    
подобається	              подобатися                                                                                                       verb:rev:pres:s:3:imperf
тому	                              тому                                                                                                                    conj:subord 
 ваші	                              ваш                                                                                                                      pron:pos                               (pron:pos:v_naz)                   
                                
слова	                              слово                                                                                                                   noun:p:v_naz 
                                
то	                               то                                                                                                                        conj:subord 
пуста	                               пустий                                                                                                                 adj:f:v_naz 
балаканина	               балаканина                                                                                                        noun:f:v_naz 

Я	                                я                                                                                                             pron:pers:s:1:v_naz:anim 
в	                                в                                                                                                             prep:rv_mis:v-u 
шаленому	                шалений                                                                                                 adj:m:v_mis 
                                                  
захваті	                                захват                                                                                                     noun:m:v_mis 
від	                                від                                                                                                            prep:rv_rod 
цього	                                цей                                                                                                           pron:dem                                           (pron:dem:s:m:v_rod)
                                               
закладу	                                заклад                                                                                                      noun:m:v_rod                                   (noun:m:s:v_rod) 
По-перше	               по-перше                                                                                                       adv 
це	                             цей                                                                                                                 pron:dem                                        (pron:dem:s:m:v_naz)        

сюрприз-зустріч	               сюрприз-зустріч                                                                                          noun:m:v_naz 
                                                             
при	                              при                                                                                                                   prep:rv_mis

вході	                               вхід                                                                                                                  noun:m:v_mis 
По-друге	                                   по-друге                                                                                                        adv 
                                
я	                                   я                                                                                                                  pron:pers:s:1:v_naz:anim
б	                                   б                                                                                                                  part 
цей	                                   цей                                                                                                               pron:dem                                    (pron:dem:s:m:v_naz)
                           
ресторан	                                   ресторан                                                                                                      noun:m:v_naz 
                                 
на	                                   на                                                                                                                  prep:rv_mis 
Найкраще	                   хороший                                                                                                         adj:n:v_naz:super 
                                                 
обслуговування	                   обслуговування                                                                                            noun:n:v_naz 
                                                            
Галичини   	                   Галичина                                                                                                        noun:f:v_rod 
Насправді	                       насправді                                                                                                       adv 
таких	                                       такий                                                                                                              pron:def
                                                  
уважних	                                       уважний                                                                                                          adj:p:v_zna:compb 
                                              
офіціантів	                        офіціант                                                                                                         noun:p:v_zna:anim 
                                               
та	                                       та                                                                                                                     conj:coord 
                                              
швидких	                                       швидкий                                                                                                          adj:p:v_zna:compb 
                                              
кухарів	                                       кухар                                                                                                               noun:p:v_zna:anim 
                                               
мабуть	                                       мабуть                                                                                                             insert 
неможливо	                       неможливо                                                                                                      adv 
знайти	                                       знайти                                                                                                             verb:inf:perf 
десь	                                       десь                                                                                                                 adv  
                                                     
ще	                                       ще                                                                                                                     adv 
                                                      
По-третє	                                       по-третє                                                                                                            adv 
їжа	                                         їжа                                                                                                                    noun:f:v_naz 
Великі                                     	великий                                                                                                    adj:p:v_naz:compb 
                                     
смачні	                               смачний                                                                                                    adj:p:v_naz:compb 
                                     
порції	                               порція                                                                                                        noun:p:v_naz 
                                    
Щира	                                щирий                                                                                                        adj:f:v_naz:compb 
порада	                                порада                                                                                                      noun:f:v_naz                            ( noun:f:s:v_naz)
візьміть	                               взяти                                                                                                          verb:impr:p:2:perf 
різного	                               різний                                                                                                         adj:n:v_rod 
                                 
і	                               і                                                                                                                    conj:coord 
                                  
порції	                              порція                                                                                                           noun:p:v_naz
на	                             на                                                                                                                   prep:rv_mis 
двох	                             двоє                                                                                                               numr:p:v_mis 
                                
Це	                                 цей                                                                                                              pron:dem                               ( pron:dem:n:s:v_naz)
                             
варто	                                варто                                                                                                            predic 
спробувати	               спробувати                                                                                                   verb:inf:perf 
а	                               а                                                                                                                      conj:coord 
                        
одна	                                один                                                                                                                numr:f:v_naz 
людина	                                людина                                                                                                            noun:f:v_naz:anim 
має	                                мати                                                                                                                 verb:pres:s:3:imperf 


бути	                                 бути                                                                                                                  verb:inf:imperf 
голодною	                  голодний                                                                                                       adj:f:v_oru:compb 
щоб	                                  щоб                                                                                                                 conj:subord 
                                                         
з'їсти	                                  з'їсти                                                                                                                 verb:inf:perf 
більше	                                  багато                                                                                                               adv:compb                             (adv:compr) 

однієї	                                 один                                                                                                                   numr:f:v_rod 
порції	                                 порція                                                                                                                noun:f:v_rod
Отже	                                  отже                                                                                                                      part 
не	                                  не                                                                                                                           part 
знаю	                                  знати                                                                                                                     verb:pres:s:1:imper 
як	                                  як                                                                                                                            adv
щодо	                                  щодо                                                                                                                        prep:rv_rod 
проте	                                    проте                                                                                                                       conj:coord 
                              
по-королівськи	                     по-королівськи                                                                                                       adv 
Ви	                                     ви                                                                                                                            pron:pers:p:2:v_naz:anim 
                                                             
себе	                                     себе                                                                                                                         pron:refl:m:v_zna
                                                              
точно	                                     точно                                                                                                                       adv 
відчуєте	                                     відчути                                                                                                                     verb:futr:p:2:perf 
особливо   	                      особливо                                                                                                                  adv 
в	                                      в                                                                                                                                prep:rv_mis
Прочитав	                         прочитати                                                               verb:past:m:perf 
відгук	                                         відгук                                                                       noun:m:v_zna 
                                                     
Алекса	                                         Алекс                                                                         noun:m:v_rod:anim:fname
                                                    
і	                                          і                                                                                conj:coord 
                                                     
згадав	                                        згадати                                                                      verb:past:m:perf 
про	                                        про                                                                             prep:rv_zna 
власні	                                        власний                                                                      adj:p:v_zna
                                                   
відвідини	                                        відвідини                                                                     noun:p:v_zna 
                                                     
ресторану	                        ресторан                                                                     noun:m:v_rod
                                                       
навесні	                                        навесні                                                                         adv 
цього	                                        цей                                                                                pron:dem                                               ( pron:dem:s:m:v_naz)
                                                  
року	                                        рік                                                                                 noun:m:v_rod
                                                    
Прийшли	                                        прийти                                                                               verb:past:p:perf 
ми	                                        ми                                                                                      pron:pers:p:1:v_naz:anim 
туди	                                        туди                                                                                   adv
своєю	                                        свій                                                                                    pron:pos                                                 (pron:pos:s:f:v_oru)
компанією	                        компанія                                                                            noun:f:v_oru                                           ( noun:f:s:v_oru)
ресторан             	                        ресторан                                                                           noun:m:v_naz                                           ( noun:m:s:v_naz) 
                                           
був	                                        бути                                                                                   verb:past:m:imperf 
нам	                                        ми                                                                                       pron:pers:p:1:v_dav:anim 
рекомендований	                        рекомендований                                                               adjp:pasv:pres:past:m:v_naz
                                                                
з	                                        з                                                                                             prep:rv_oru 
собою	                                        себе                                                                                       pron:refl:m:v_oru 
                                  
ми	                                        ми                                                                                          pron:pers:p:1:v_naz:anim 
мали	                                        мати                                                                                      verb:past:p:imperf 
ключик	                                        ключик                                                                                    noun:m:v_zna                                         (noun:m:s:v_zna) 
тому	                                         тому                                                                                         conj:subord  

особливих	                         особливий                                                                                adj:p:v_zna 
сюрпризів	                         сюрприз                                                                                   noun:p:v_rod                                          
не	                                         не                                                                                              part 
очікували	                         очікувати                                                                                  verb:past:p:imperf 
Усі	                                         увесь                                                                                           pron:dem                                          ( pron:dem:p:v_naz)
                                   
були	                                         бути                                                                                             verb:past:p:imperf 
в	                                         в                                                                                                   prep:rv_mis:v-u 
хорошому	                         хороший                                                                                       adj:m:v_mis:compb 
                                                    
настрої	                                         настрій                                                                                         noun:m:v_mis 
                                                 
на	                                           на                                                                                               prep:rv_zna
огріхи	                                           огріх                                                                                           noun:p:v_zna
                                          
у	                                           у                                                                                                 prep:rv_mis:v-u 
роботі	                                           робота                                                                                        noun:f:v_mis                                    ( noun:f:s:v_mis)
закладу	                                           заклад                                                                                        noun:m:v_mis                                   (noun:m:s:v_mis)
                                         
вирішили	                                           вирішити                                                                                     verb:past:p:perf 
не	                                           не                                                                                                part 
звертати	                                           звертати                                                                                     verb:inf:imperf 
уваги	                                           увага                                                                                           noun:f:v_rod                                       
Проте	                                            проте                                                                                            insert 
їх	                                            вони                                                                                              pron:pers:p:3:v_zna:anim
                              
було	                                            бути                                                                                               verb:past:n:imperf 
настільки	                                            настільки                                                                                       adv 
багато	                                            багато                                                                                            adv 
                                
що	                                            що                                                                                                    conj:subord 
                               
згодом	                                            згодом                                                                                             adv 
не	                                            не                                                                                                     part 
зважати	                                            зважати                                                                                            verb:inf:imperf 
на	                                            на                                                                                                      prep:rv_mis 
них	                                            вони                                                                                                   pron:pers:p:3:v_mis:anim
                                
                                
ми	                                            ми                                                                                                      pron:pers:p:1:v_naz:anim
вже	                                            вже                                                                                                   adv:v-u 
просто	                                            просто                                                                                              adv:compb 
                                
не	                                            не                                                                                                       part 
могли	                                            могти                                                                                                 verb:unknown                               (verb:past:p:imperf)
Обслуговувати	                          обслуговувати                                                                                    verb:inf:imperf 
нас	                                          ми                                                                                                         pron:pers:p:1:v_zna:anim
                                                             
почав	                                          почати                                                                                                  verb:past:m:perf 
один	                                          один                                                                                                      numr:m:v_naz 
                                                             
офіціант	                                          офіціант                                                                                                noun:m:v_naz:anim 
продовжував	                         продовжувати                                                                                        verb:past:m:imperf 
другий	                                         другий                                                                                                     adj:m:v_naz 
а	                                         а                                                                                                                 conj:coord 
                            
закінчував	                         закінчувати                                                                                               verb:past:m:imperf 
уже	                                         уже                                                                                                             adv:v-u 
фактично	                         фактично                                                                                                    adv 
третій	                                        третій                                                                                                           adj:m:v_zna 
Цей	                                         цей                                                                                                                 pron:dem                            (pron:dem:s:m:v_naz) 
                           
третій	                                        третій                                                                                                              adj:m:v_naz 
                             
був	                                        бути                                                                                                                verb:past:m:imperf 
очевидно	                      очевидно                                                                                                          insert 
стажером	                     стажер                                                                                                               noun:m:v_oru:bad:anim 
і	                                       і                                                                                                                         conj:coord 
                                               
навчали	                                      навчати                                                                                                             verb:past:p:imperf 
його	                                      він                                                                                                                      pron:pos                                  (pron:pos:m:s:v_zna)
                                               
за	                                      за                                                                                                                       prep:rv_oru
нашим	                                      наш                                                                                                                     pron:pos                                  (pron:pos:m:s:v_oru)
                                            
столом	                                     стіл                                                                                                                      noun:m:v_oru                         ( noun:m:s:v_oru) 
Усі	                                     увесь                                                                                                                pron:dem                              (pron:dem:p:v_naz)     
                          
салати	                                    салат                                                                                                                 noun:p:v_naz 
                                          
були	                                    бути                                                                                                                   verb:past:p:imperf 
заправлені	                    заправлений                                                                                                     adjp:pasv:past:p:v_naz 
                                                         
майонезом	                   майонез                                                                                                               noun:m:v_oru 
ніби	                                   ніби                                                                                                                       conj:subord 
                                                            
жодних	                                   жодний                                                                                                                   pron                           ( pron:p:v_rod)
                                                            
інших	                                    інший                                                                                                                     pron:def 
                                                            
приправ	                                   приправа                                                                                                               noun:p:v_rod              (noun:p:v_zna)
                                   
на	                                   на                                                                                                                   prep:rv_mis 
кухні	                                   кухня                                                                                                              noun:f:v_mis
                                                  
не	                                   не                                                                                                                   part 
було	                                   бути                                                                                                               verb:past:n:imperf 
,	- 
- 
а	                                   а                                                                                                                    conj:coord 
                                                
фантазії	                                  фантазія                                                                                                        noun:f:v_rod
                                                
кухарів	                                   кухар                                                                                                             noun:p:v_rod:anim 
                                               
вистачило	                  вистачити                                                                                                      verb:past:n:perf 
лише	                                  лише                                                                                                                part 
на	                                  на                                                                                                                    prep:rv_mis 
те	                                  той                                                                                                                  pron:dem                                    (pron:dem:n:s:v_naz)                                  
щоб	                                  щоб                                                                                                                  conj:subord 
                                    
прикрасити	                   прикрасити                                                                                                   verb:inf:perf 
їх	                                   вони                                                                                                              pron:pers:p:3:v_zna:anim
                                                        
яйцями	                                    яйце                                                                                                              noun:p:v_oru 
порізаними	                    порізаний                                                                                                     adjp:pasv:past:p:v_oru 
на	                                    на                                                                                                                  prep:rv_zna
чотири	                                    чотири                                                                                                           numr:p:v_zna
                                                        
частини	                                     частина                                                                                                         noun:f:v_zna 
Стейки	                                           стейк                                                                                                        noun:p:v_naz 
                               
які	                                             який                                                                                                      pron:int:rel:def                  (pron:int:rel:def:p:v_naz)
                              
були	                                             бути                                                                                                       verb:past:p:imperf 
нам	                                             ми                                                                                                           pron:pers:p:1:v_dav:anim 
наполегливо	                             наполегливо                                                                                          adv:compb 
рекомендовані	                             рекомендований                                                                                    adjp:pasv:pres:past:p:v_naz 
                                                              
виявилися	                             виявитися                                                                                              verb:rev:past:p:perf 
якимись	                                             якийсь                                                                                                     pron:ind                           ( pron:ind:p:v_oru)
напівсирими	                             напівсирий                                                                                              adj:p:v_oru 
м'язами	                                              м'яз                                                                                                         noun:p:v_oru 
іншого	                                              інший                                                                                                     pron:def                               (pron:def:m:s:v_rod)
                                                             
порівняння	                            порівняння                                                                                              noun:n:v_naz                        
                                                             
я	                                             я                                                                                                              pron:pers:s:1:v_naz:anim 
просто	                                            просто                                                                                                     adv:compb 
                                                             
не	                                             не                                                                                                           part 
можу	                                             могти                                                                                                      verb:unknown                      (verb:pres:1:s:imperf)
знайти	                                             знайти                                                                                                    verb:inf:perf 
Замовили	                               замовити                                                                                          verb:past:p:perf 
ми	                                              ми                                                                                                        pron:pers:p:1:v_naz:anim
їх	                                              вони                                                                                                    pron:pers:p:3:v_zna:anim
тож	                                            тож                                                                                                           conj:subord 
                                                 
уявляю	                                           уявляти                                                                                                      verb:pres:s:1:imperf 
що	                                           що                                                                                                               pron:int:rel:n:v_naz 
                              
б	                                           б                                                                                                                  part 
нам	                                           ми                                                                                                                pron:pers:p:1:v_dav:anim
принесли         	                           принести                                                                                                     verb:past:p:perf 
якби	                                         якби                                                                                                               conj:subord 
ми	                                         ми                                                                                                                  pron:pers:p:1:v_naz:anim
замовили	                         замовити                                                                                                       verb:past:p:perf 
їх	                                         вони                                                                                                               pron:pers:p:3:v_rod:anim
                                               
З	                                            з                                                                                                                    prep:rv_rod
усього	                                           увесь                                                                                                              pron:dem                           (pron:dem:m:s:v_rod)
                              
замовленого	                           замовлений                                                                                                   adjp:pasv:past:n:v_rod 
                                                             
усім	                                          увесь                                                                                                                pron:dem                            (pron:dem:p:v_dav)
                                                              
сподобалося	                          сподобатися                                                                                                     verb:rev:past:n:perf 
лише	                                          лише                                                                                                                  part 
вино	                                          вино                                                                                                                  noun:n:v_zna 
                                                             
але	                                           але                                                                                                                   conj:coord 
                                                            
заслуги	                                           заслуга                                                                                                           noun:f:v_rod 
                                                           

закладу                	                          заклад                                                                                                               noun:m:v_rod                        (noun:m:s:v_rod)
                                   

у	                                            у                                                                                                                        prep:rv_mis:v-u 
цьому	                                          цей                                                                                                                      pron:dem                              (pron:dem:m:s:v_mis) 
                                    
не	                                          не                                                                                                                         part 
було	                                         бути                                                                                                                     verb:past:n:imperf 
жодної	                                         жодний                                                                                                                pron                                         (pron:f:s:v_rod) 
Проголосити	                         проголосити                                                                       verb:inf:perf 
себе	                                          себе                                                                                   pron:refl:m:v_rod  
                                                                    
найдорожчим	                         дорогий                                                                               adj:m:v_oru:super 
                                                                    
рестораном	                        ресторан                                                                              noun:m:v_oru 
Галичини	                                        Галичина                                                                              noun:f:v_rod 
дуже	                                         дуже                                                                                     adv

просто	                                         просто                                                                                adv:compb 
А	                                       а                                                                                  part 
чому	                                       що                                                                                pron:int:rel:n:v_dav 
                                    
не	                                       не                                                                                  part 
позиціонувати	                       позиціонувати                                                             verb:inf:bad 
себе	                                       себе                                                                               pron:refl:m:v_rod
                                                        
                                                         
рестораном	                      ресторан                                                                        noun:m:v_oru 
з	                                       з                                                                                     prep:rv_oru 
найвищим	                      високий                                                                          adj:m:v_oru:super 
                                                           
рівнем	                                        рівень                                                                             noun:m:v_oru 
обслуговування	                        обслуговування                                                             noun:n:v_rod
                                                              
чи	                                      чи                                                                                      conj:coord
                                                   
найкращою	                      хороший                                                                             adj:f:v_oru:super 
кухнею	                                      кухня                                                                                   noun:f:v_oru 
у	                                      у                                                                                          prep:rv_mis:v-u 
Галичині	                                      Галичина                                                                             noun:f:v_mis 
Чи	                                        чи                                     conj:coord
може	                                       може                                   insert 

власники	                                      власник                               noun:p:v_naz:anim 
                                      
мережі	                                       мережа                                noun:f:v_rod
                                       
ніколи	                                        ніколи                                  pron:neg 
не	                                        не                                          part 
бували	                                        бувати                                verb:past:p:imperf 
далі	                                       далі                                        adv 
Польщі	                                      Польща                                 noun:f:v_rod
                                       
і	                                         і                                           conj:coord 
                                      
не	                                         не                                         part 
знають	                                        знати                                    verb:pres:p:3:imperf 
що	                                         що                                         pron:int:rel:n:v_naz 
                                  
у	                                           у                                          prep:rv_mis:v-u 
ресторані	                       ресторан                                 noun:m:v_mis 
все	                                       весь                                         adv:v-u 
 
починається	                      починатися                               verb:rev:pres:s:3:imperf 
з	                                      з                                                 prep:rv_rod 
кухні	                                      кухня                                          noun:f:v_rod
                                                             
та	                                        та                                               conj:coord 
                                                        
сервісу	                                        сервіс                                        noun:m:v_rod
                                                            
а	                                         а                                              conj:coord 
                                                                   
не	                                         не                                             part 
з	                                          з                                              prep:rv_rod
інтер'єру 	                        інтер'єр                                    noun:m:v_rod
                                                       noun:m:v_mis 
                                                       noun:m:v_rod 
Пропоную	пропонувати                     verb:pres:s:1:imperf 
їм	                вони                                   pron:pers:p:3:v_dav:anim
                                                                
проводити	проводити                         verb:inf:imperf
тренінги	               тренінг                               noun:p:v_zna
                                                                        
для	                 для                                   prep:rv_rod 
своїх	                 свій                                   pron:pos                     (pron:pos:p:v_rod)       
                                                                         
офіціантів	офіціант                             noun:p:v_rod:anim 
                                                                         
на	                на                                       prep:rv_mis 
власних	                власний                             adj:p:v_mis 
                                                                     
забавах      	забава                              noun:p:v_mis 
та	                 та                                     conj:coord 
                                                                 
днях	                день                                   noun:p:v_mis 
народження	народження                       noun:n:v_rod                   
                                                                           
Тоді	                      тоді                                        adv 
можливо	                     можливо                                 adv                   (insert)
якість	                      якість                                     noun:f:v_naz 
                                  
обслуговування	     обслуговування                     noun:n:v_rod
                                                                
у	                       у                                              prep:rv_rod:v-u 
нас	                      ми                                             pron:pers:p:1:v_rod:anim 
                                                                
поступово	      поступово                                 adv 
і	                        і                                               conj:coord 
                                                             
зміниться	        змінитися                              verb:rev:futr:s:3:perf 
на	                          на                                        prep:rv_zna
краще	                          хороший                              adj:n:v_zna:compr 
                                                              
Висловлюю	висловлювати         verb:pres:s:1:imperf 
подяку	                подяка                      noun:f:v_zna 
піаністу	                піаніст                       noun:m:v_dav:anim 
Класна	            класний                      adj:f:v_naz 
музика	           музика                        noun:f:v_naz 
                                          
Без	                  без                        prep:rv_rod 
нього	                  він                         pron:pers:m:3:v_rod:anim 
                                 
в	                   в                           prep:rv_mis:v-u 
Масонах	                   масон                     noun:p:v_mis:anim 

було	                  бути                        verb:past:n:imperf 
б	                  б                              part 
дуже	                  дуже                        adv 
                                  
сумно	                 сумно                        adv:compb 
 
на	                                           на                                                                                                                  prep:rv_zna
даний	                                           даний                                                                                                            adjp:pasv:past:m:v_zna
                             
момент	                                            момент                                                                                                         noun:m:v_zna
                                
я	                                             я                                                                                                                   pron:pers:s:1:v_naz:anim 
зі	                                             зі                                                                                                                  prep:rv_oru 
своєю	                                           свій                                                                                                                pron:pos                                    (pron:pos:f:s:v_oru)
коханою	                                           кохана                                                                                                            noun:f:v_oru:anim

дружиною	                           дружина                                                                                                          noun:f:v_oru                            ( noun:f:s:v_oru) 
                                                 
знаходимося	                          знаходитися                                                                                                    verb:rev:pres:p:1:imperf 
в	                                          в                                                                                                                       prep:rv_mis:v-u 
цьому	                                         цей                                                                                                                    pron:dem                               (pron:dem:m:s:v_mis)
                                                        
чудовому	                          чудовий                                                                                                            adj:n:v_mis:compb 
                                                         
місці	                                           місце                                                                                                                 noun:n:v_mis                        (noun:n:s:v_mis) 
Обстановка	                                обстановка                                                       noun:f:v_naz 
просто	                                                просто                                                               adv:compb 
                                                           
дивовижна	                               дивовижний                                                       adj:f:v_naz:compb 
офіціант	                                                офіціант                                                              noun:m:v_naz:anim                                   ( noun:m:s:v_naz:anim)
зустрів	                                                зустріти                                                              verb:past:m:perf 
на	                                                на                                                                        prep:rv_mis 
вході	                                                 вхід                                                                     noun:m:v_mis 
провів	                                                провести                                                            verb:past:m:perf 
до	                                                до                                                                        prep:rv_rod 
вільного	                                                вільний                                                               adj:n:v_rod:compb 
                                                  
місця	                                                місце                                                                   noun:n:v_rod 
дуже	                                               дуже                                                                      adv

чемний	                                              чемний                                                                   adj:m:v_naz:compb 
                                                  
і	                                                і                                                                            conj:coord 
                                                    
привітний	                              привітний                                                              adj:m:v_naz:compb 
                                                   
Фішка	                                                фішка                                                                       noun:f:v_naz                                (noun:f:s:v_naz) 
з	                                                з                                                                              prep:rv_oru 
нулями	                                                нуль                                                                         noun:p:v_oru 
в	                                                в                                                                               prep:rv_mis:v-u 
рахунку                            	                рахунок                                                                   noun:m:v_mis                                (noun:m:s:v_mis) 
                                    
це	                                                цей                                                                           pron:dem                                        (pron:dem:n:s:v_naz)
                                  
і	                                                  і                                                                                part 
не	                                                  не                                                                             part 
більше	                                                  багато                                                                      adv:compr

ми	                                                  ми                                                                       pron:pers:p:1:v_naz:anim 
вже	                                                  вже                                                                     adv:v-u 
другий	                                                  другий                                                                adj:m:v_naz                                       (numb:m:s:v_naz)
                                 
раз	                                                 раз                                                                       noun:m:v_naz 
                                    
тут                                                           тут                                                                       adv 
і	                                                  і                                                                          conj:coord 
                                
казусів	                                                 казус                                                                   noun:p:v_rod 
і	                                                  і                                                                           conj:coord 
                                  
нарікань	                                                 нарікання                                                             noun:p:v_rod 
на	                                                  на                                                                        prep:rv_zna
обслуговування	                                 обслуговування                                                  noun:n:v_naz 
                                                                
не	                                                  не                                                                         part 
було	                                                  бути                                                                      verb:past:n:imperf 
Чудове	                                                 чудовий                                                                adj:n:v_naz:compb 
                                
місце	                                                  місце                                                                     noun:n:v_naz                               (noun:n:s:v_naz)
                                    
радимо	                                                   радити                                                                verb:pres:p:1:imperf 
всім	                                                   весь                                                                     pron:dem                                       (pron:dem:p:v_rod)
Вчора	                                                вчора                                                                      adv:v-u 
ввечері	                                                ввечері                                                                   adv:v-u 
були	                                                бути                                                                        verb:past:p:imperf 
у                                                              у	                                                                prep:rv_mis:v-u 
ресторації	                                ресторація                                                              noun:f:v_mis 
                                                      
з	                                               з                                                                                prep:rv_oru 
подругами	                               подруга                                                                    noun:p:v_oru:anim 
вирішили	                                                вирішити                                                                    verb:past:p:perf 
відмітити	                                                відмітити                                                                    verb:inf:perf 
останній	                                                останній                                                                     adj:m:v_zna
                                                
день	                                               день                                                                              noun:m:v_zna                                    (noun:m:s:v_zna)
                                               
у	                                                у                                                                                    prep:rv_mis:v-u 
Львові	                                                Львів                                                                            noun:m:v_mis 
самі	                                               сам                                                                                  pron:def                                            (pron:def:p:v_naz)

ж	                                               ж                                                                                     part 
з	                                               з                                                                                     prep:rv_rod 
Києва	                                               Київ                                                                                noun:m:v_rod 
Так	                                              так                                                                                    adv 
ось	                                              ось                                                                                    part 
Я	                                               я                                                                                       pron:pers:s:1:v_naz:anim 
У	                                               у                                                                                       prep :rv_mis:v-u 
ЗАХВАТІ	                                              захват                                                                               noun:m:v_mis 

Ніби	                                                 ніби                                                                                  part 
прості	                                                 простий                                                                           adj:p:v_naz:compb 
                                   
на	                                                 на                                                                                      prep:rv_zna
перший	                                                 перший                                                                              adj:m:v_zna
                                  
погляд	                                                 погляд                                                                              noun:m:v_zna
                                  
страви	                                                  страва                                                                              noun:p:v_zna
                                  
хоча	                                                  хоча                                                                                 conj:subord 
                            
одна	                                                 один                                                                                  numr:f:v_naz 
з	                                                 з                                                                                        prep:rv_rod
подруг	                                                 подруга                                                                              noun:p:v_rod:anim 
                                
за	                                                  за                                                                                      prep:rv_zna
рік	                                                  рік                                                                                      noun:m:v_zna                          (noun:m:s:v_zna)      
                                  
тільки	                                                 тільки                                                                                    adv 
                                 
там	                                                  там                                                                                       adv
знайшла	                                                  знайти                                                                              verb:past:f:perf 
так	                                                   так                                                                                   adv
добре	                                                   добре                                                                               adv 

смакували	                                   смакувати                                                                        verb:past:p:imperf 
вони	                                                     вони                                                                                 pron:pers:p:3:v_naz:anim
легкі	                                                     легкий                                                                              adj:p:v_naz:compb 
                                               
і	                                                      і                                                                                        conj:coord 
                                                 
надзвичайно	                                   надзвичайно                                                                      adv 
смачні	                                                   смачний                                                                             adj:p:v_naz:compb 
кожна	                                                      кожний                                                                                  pron:def                                       (pron:def:f:s:v_naz)
гривня	                                                      гривня                                                                                  noun:f:v_naz 
себе	                                                      себе                                                                                      pron:refl:m:v_rod 
                                                           
виправдовує	                                      виправдовувати                                                                   verb:pres:s:3:imperf 
Вина	                                                     вина                                                                                       noun:p:v_naz 
вино                 
також	                                                     також                                                                                      adv 
                          
дуже	                                                      дуже                                                                                       adv

сподобались	                                     сподобатися                                                                           verb:rev:past:p:perf 
Авжеж	                                                      авжеж                                                                                      part 
атмосфера	                                      атмосфера                                                                              noun:f:v_naz 
закладу	                                                      заклад                                                                                     noun:m:v_rod                             (noun:m:s:v_rod)
                                                      
мала	                                                      мати                                                                                         verb:past:f:imperf 
велике	                                                      великий                                                                                   adj:n:v_zna:compb 
                                                    
значення          	                                      значення                                                                                 noun:n:v_zna
Інтер'єр	                                                    інтер'єр                                                                                     noun:m:v_naz 
                                  
незабутній	                                   незабутній                                                                                 adj:m:v_naz
відчуття	                                                    відчуття                                                                                    noun:n:v_naz 

старого	                                                     старий                                                                                      adj:m:v_rod:compb 
                                    
закритого	                                     закритий                                                                                  adjp:pasv:past:m:v_rod:compb
                                                    
клубу	                                                     клуб                                                                                          noun:m:v_rod
Офіціанти	                                    офіціант                                                                                     noun:p:v_naz:anim 
                                                
та                                                                та                                                                                                conj:coord 
                                              
бармен	                                                     бармен                                                                                       noun:m:v_naz:anim              (noun:m:s:v_naz:anim) 
привітні	                                                    привітний                                                                                    adj:p:v_naz:compb 
комунікабельні	                                     комунікабельний                                                                        adj:p:v_naz 
                                                               
так	                                                       так                                                                                             adv
склалося	                                                       скластися                                                                                  verb:rev:past:n:perf 
що	                                                       що                                                                                               pron:int:rel:n:v_naz 
                                    
наш	                                                       наш                                                                                             pron:pos                                 (pron:pos:m:s:naz)  
                                    
столик	                                                       столик                                                                                        noun:m:v_naz                         ( noun:m:s:v_naz)  
                                  
обслуговував	                                    обслуговувати                                                                             verb:past:m:imperf 
менеджер	                                    менеджер                                                                                      noun:m:v_naz:anim                 (noun:m:s:v_naz:anim) 
просто	                                                     просто                                                                                            part 
                                     
було	                                                     бути                                                                                                verb:past:n:imperf 
чому	                                                     що                                                                                                    pron:int:rel                                                        
я	                                                     я                                                                                                       pron:pers:s:1:v_naz:anim
не	                                                     не                                                                                                     part  
дивуюся	                                                    дивуватися                                                                                      verb:rev:pres:s:1:imperf 
Ми	                                                  ми                                                                             pron:pers:p:1:v_naz:anim 
відчули	                                                 відчути                                                                      verb:past:p:perf 
те	                                                  той                                                                            pron:dem                                                  (pron:dem:n:s:v_naz) 
що	                                                 що                                                                               conj:subord 
                                 
клієнти	                                                клієнт                                                                        noun:p:v_naz:anim 
                                
у	                                                 у                                                                                prep:rv_mis:v-u 
закладі	                                                заклад                                                                       noun:m:v_mis                                   (noun:m:s:v_mis) 
на	                                                на                                                                               prep:rv_mis 
першому	                                                перший                                                                       adj:n:v_mis
                                
місці	                                                місце                                                                            noun:n:v_mis                                   (noun:n:s:v_mis) 
це	                                                  цей                                                                             pron:dem                                            (pron:dem:n:s:v_naz)
                                 
надзвичайне	                                 надзвичайний                                                             adj:n:v_naz 
                                                           
і	                                                        і                                                                              conj:coord 
                                                           
досить	                                                   досить                                                                        adv 
                                                          
рідке	                                                  рідкий                                                                           adj:n:v_naz:compb                            
                                                                                                                                                       
на	                                                  на                                                                                   prep:rv_zna 
наш	                                                  наш                                                                                 pron:pos                                       (pron:pos:m:s:v_naz)
                                                        
час	                                                   час                                                                                noun:m:v_zna 
                                             
явище	                                                  явище                                                                              noun:n:v_naz 
                                          
Надрукувала	                                 надрукувати                                                                  verb:past:f:perf 
багато	                                                 багато                                                                             adv 
                                                       
але	                                                  але                                                                                    conj:coord 
                                                     
вилила	                                                  вилити                                                                              verb:past:f:perf 
всі	                                                   весь                                                                                  pron:dem                                   ( pron:dem:p:v_zna)
                                                        
свої	                                                   свій                                                                                   pron:pos                                     ( pron:pos:p:v_zna)
                                                         
емоції	                                                   емоція                                                                                noun:p:v_zna
                                       
та	                                                    та                                                                                       conj:coord 
                                           
думки	                                                   думка                                                                                  noun:p:v_zna
                                       
Я	                                                     я                                                                                       pron:pers:s:1:v_naz:anim 
вважаю	                                                вважати                                                                                verb:pres:s:1:imperf  
що	                                                  що                                                                                        pron:int:rel:n:v_naz 
                                
ресторація	                                ресторація                                                                             noun:f:v_naz 
це	                                                 цей                                                                                        pron:dem                                             (pron:dem:n:s:v_naz)
                                 
те	                                                той                                                                                          pron:dem                                              (pron:dem:n:s:v_naz)
                               
місце	                                                 місце                                                                                       noun:n:v_naz                                         (noun:n:s:v_naz) 

куди	                                                 куди                                                                                        adv  
необхідно	                                 необхідно                                                                                adv:compb 
сходити	                                                 сходити                                                                                   verb:inf:perf 
                                                  
у	                                                  у                                                                                             prep:rv_mis:v-u 
Львові	                                                 Львів                                                                                       noun:m:v_mis 
Дух	                                                 дух                                                                                           noun:m:v_naz                                  (noun:m:s:v_naz) 
                                         
                                     
міста	                                                  місто                                                                                        noun:n:v_rod                                  (noun:n:s:v_rod)    
                                          
відчувається	                                 відчуватися                                                                              verb:rev:pres:s:3:imperf
