Voitsiv 20-30 male
пуста	                               пустий                                                                                                                 adj:f:v_naz  joy 0 sadness 70 anger 0 fear 0 amazement 0 disgust 0
балаканина	               балаканина                                                                                                        noun:f:v_naz  joy 0 sadness 70 anger 46 fear 0 amazement 0 disgust 0
Я	                                я                                                                                                             pron:pers:s:1:v_naz:anim  joy 0 sadness 0 anger 0 fear 0 amazement 0 disgust 0
в	                                в                                                                                                             prep:rv_mis:v-u  joy 0 sadness 0 anger 0 fear 0 amazement 0 disgust 0
шаленому	                шалений                                                                                                 adj:m:v_mis  joy 72 sadness 0 anger 0 fear 0 amazement 43 disgust 0
захваті	                                захват                                                                                                     noun:m:v_mis  joy 72 sadness 0 anger 0 fear 0 amazement 37 disgust 0
від	                                від                                                                                                            prep:rv_rod  joy 0 sadness 0 anger 0 fear 0 amazement 0 disgust 0
цього	                                цей                                                                                                           pron:dem                                           (pron:dem:s:m:v_rod) joy 0 sadness 0 anger 0 fear 0 amazement 0 disgust 0
закладу	                                заклад                                                                                                      noun:m:v_rod                                   (noun:m:s:v_rod)  joy 0 sadness 0 anger 0 fear 0 amazement 0 disgust 0
По-перше	               по-перше                                                                                                       adv  joy 0 sadness 0 anger 0 fear 0 amazement 0 disgust 0
це	                             цей                                                                                                                 pron:dem                                        (pron:dem:s:m:v_naz)         joy 0 sadness 0 anger 0 fear 0 amazement 0 disgust 0
сюрприз-зустріч	               сюрприз-зустріч                                                                                          noun:m:v_naz  joy 85 sadness 0 anger 0 fear 43 amazement 65 disgust 0
при	                              при                                                                                                                   prep:rv_mis joy 0 sadness 0 anger 0 fear 0 amazement 0 disgust 0
вході	                               вхід                                                                                                                  noun:m:v_mis  joy 48 sadness 0 anger 0 fear 0 amazement 0 disgust 0
По-друге	                                   по-друге                                                                                                        adv  joy 0 sadness 0 anger 0 fear 0 amazement 0 disgust 0
я	                                   я                                                                                                                  pron:pers:s:1:v_naz:anim joy 0 sadness 0 anger 0 fear 0 amazement 0 disgust 0
б	                                   б                                                                                                                  part  joy 0 sadness 0 anger 0 fear 0 amazement 0 disgust 0
цей	                                   цей                                                                                                               pron:dem                                    (pron:dem:s:m:v_naz) joy 0 sadness 0 anger 0 fear 0 amazement 0 disgust 0
ресторан	                                   ресторан                                                                                                      noun:m:v_naz  joy 68 sadness 0 anger 0 fear 0 amazement 0 disgust 0
на	                                   на                                                                                                                  prep:rv_mis  joy 0 sadness 0 anger 0 fear 0 amazement 0 disgust 0
Найкраще	                   хороший                                                                                                         adj:n:v_naz:super  joy 75 sadness 0 anger 0 fear 0 amazement 0 disgust 0
обслуговування	                   обслуговування                                                                                            noun:n:v_naz  joy 30 sadness 0 anger 0 fear 0 amazement 0 disgust 0
Галичини   	                   Галичина                                                                                                        noun:f:v_rod  joy 60 sadness 0 anger 0 fear 0 amazement 0 disgust 0
Насправді	                       насправді                                                                                                       adv  joy 14 sadness 0 anger 0 fear 0 amazement 0 disgust 0
таких	                                       такий                                                                                                              pron:def joy 0 sadness 0 anger 0 fear 0 amazement 0 disgust 0
уважних	                                       уважний                                                                                                          adj:p:v_zna:compb  joy 60 sadness 0 anger 0 fear 0 amazement 0 disgust 0
офіціантів	                        офіціант                                                                                                         noun:p:v_zna:anim  joy 30 sadness 0 anger 0 fear 0 amazement 0 disgust 0
та	                                       та                                                                                                                     conj:coord  joy 0 sadness 0 anger 0 fear 0 amazement 0 disgust 0
швидких	                                       швидкий                                                                                                          adj:p:v_zna:compb  joy 60 sadness 0 anger 0 fear 0 amazement 0 disgust 0
кухарів	                                       кухар                                                                                                               noun:p:v_zna:anim  joy 15 sadness 0 anger 0 fear 0 amazement 0 disgust 0
мабуть	                                       мабуть                                                                                                             insert  joy 0 sadness 0 anger 0 fear 0 amazement 0 disgust 0
неможливо	                       неможливо                                                                                                      adv  joy 0 sadness 59 anger 22 fear 0 amazement 0 disgust 0
знайти	                                       знайти                                                                                                             verb:inf:perf  joy 60 sadness 0 anger 0 fear 0 amazement 0 disgust 0
десь	                                       десь                                                                                                                 adv   joy 0 sadness 0 anger 0 fear 0 amazement 0 disgust 0
ще	                                       ще                                                                                                                     adv  joy 0 sadness 0 anger 0 fear 0 amazement 0 disgust 0
По-третє	                                       по-третє                                                                                                            adv  joy 0 sadness 0 anger 0 fear 0 amazement 0 disgust 0
їжа	                                         їжа                                                                                                                    noun:f:v_naz  joy 64 sadness 0 anger 0 fear 0 amazement 0 disgust 0
Великі                                     	великий                                                                                                    adj:p:v_naz:compb  joy 75 sadness 0 anger 0 fear 0 amazement 0 disgust 0
смачні	                               смачний                                                                                                    adj:p:v_naz:compb  joy 60 sadness 0 anger 0 fear 0 amazement 0 disgust 0
порції	                               порція                                                                                                        noun:p:v_naz  joy 75 sadness 0 anger 0 fear 0 amazement 0 disgust 0
Щира	                                щирий                                                                                                        adj:f:v_naz:compb  joy 62 sadness 0 anger 0 fear 0 amazement 0 disgust 0
порада	                                порада                                                                                                      noun:f:v_naz                            ( noun:f:s:v_naz) joy 62 sadness 0 anger 0 fear 0 amazement 0 disgust 0
візьміть	                               взяти                                                                                                          verb:impr:p:2:perf  joy 6 sadness 0 anger 0 fear 0 amazement 0 disgust 0
різного	                               різний                                                                                                         adj:n:v_rod  joy 29 sadness 0 anger 0 fear 0 amazement 0 disgust 0
і	                               і                                                                                                                    conj:coord  joy 1 sadness 0 anger 0 fear 0 amazement 0 disgust 0
порції	                              порція                                                                                                           noun:p:v_naz joy 75 sadness 0 anger 0 fear 0 amazement 0 disgust 0
на	                             на                                                                                                                   prep:rv_mis  joy 1 sadness 0 anger 0 fear 0 amazement 0 disgust 0
двох	                             двоє                                                                                                               numr:p:v_mis  joy 0 sadness 0 anger 0 fear 0 amazement 0 disgust 0
Це	                                 цей                                                                                                              pron:dem                               ( pron:dem:n:s:v_naz) joy 0 sadness 0 anger 0 fear 0 amazement 0 disgust 0
варто	                                варто                                                                                                            predic  joy 45 sadness 0 anger 0 fear 0 amazement 0 disgust 0
спробувати	               спробувати                                                                                                   verb:inf:perf  joy 60 sadness 0 anger 0 fear 0 amazement 0 disgust 0
а	                               а                                                                                                                      conj:coord  joy 4 sadness 0 anger 0 fear 0 amazement 0 disgust 0
одна	                                один                                                                                                                numr:f:v_naz  joy 0 sadness 25 anger 0 fear 0 amazement 0 disgust 0
людина	                                людина                                                                                                            noun:f:v_naz:anim  joy 29 sadness 0 anger 0 fear 0 amazement 0 disgust 0
має	                                мати                                                                                                                 verb:pres:s:3:imperf  joy 4 sadness 0 anger 0 fear 0 amazement 0 disgust 0
бути	                                 бути                                                                                                                  verb:inf:imperf  joy 0 sadness 0 anger 0 fear 0 amazement 0 disgust 0
голодною	                  голодний                                                                                                       adj:f:v_oru:compb  joy 0 sadness 59 anger 0 fear 0 amazement 0 disgust 0
щоб	                                  щоб                                                                                                                 conj:subord  joy 0 sadness 0 anger 0 fear 0 amazement 0 disgust 0
з'їсти	                                  з'їсти                                                                                                                 verb:inf:perf  joy 41 sadness 0 anger 0 fear 0 amazement 0 disgust 0
більше	                                  багато                                                                                                               adv:compb                             (adv:compr)  joy 54 sadness 0 anger 0 fear 0 amazement 0 disgust 0
однієї	                                 один                                                                                                                   numr:f:v_rod  joy 0 sadness 26 anger 0 fear 0 amazement 0 disgust 0
порції	                                 порція                                                                                                                noun:f:v_rod joy 59 sadness 0 anger 0 fear 0 amazement 0 disgust 0
Отже	                                  отже                                                                                                                      part  joy 0 sadness 0 anger 0 fear 0 amazement 0 disgust 0
не	                                  не                                                                                                                           part  joy 0 sadness 0 anger 0 fear 0 amazement 0 disgust 0
знаю	                                  знати                                                                                                                     verb:pres:s:1:imper  joy 30 sadness 0 anger 0 fear 0 amazement 0 disgust 0
як	                                  як                                                                                                                            adv joy 0 sadness 0 anger 0 fear 0 amazement 0 disgust 0
щодо	                                  щодо                                                                                                                        prep:rv_rod  joy 0 sadness 0 anger 0 fear 0 amazement 0 disgust 0
проте	                                    проте                                                                                                                       conj:coord  joy 0 sadness 0 anger 0 fear 0 amazement 0 disgust 0
по-королівськи	                     по-королівськи                                                                                                       adv  joy 82 sadness 0 anger 0 fear 0 amazement 0 disgust 0
Ви	                                     ви                                                                                                                            pron:pers:p:2:v_naz:anim  joy 0 sadness 0 anger 0 fear 0 amazement 0 disgust 0
себе	                                     себе                                                                                                                         pron:refl:m:v_zna joy 0 sadness 0 anger 0 fear 0 amazement 0 disgust 0
точно	                                     точно                                                                                                                       adv  joy 0 sadness 0 anger 0 fear 0 amazement 0 disgust 0
відчуєте	                                     відчути                                                                                                                     verb:futr:p:2:perf  joy 41 sadness 0 anger 0 fear 0 amazement 0 disgust 0
особливо   	                      особливо                                                                                                                  adv  joy 53 sadness 0 anger 0 fear 0 amazement 0 disgust 0
в	                                      в                                                                                                                                prep:rv_mis joy 0 sadness 0 anger 0 fear 0 amazement 0 disgust 0
Прочитав	                         прочитати                                                               verb:past:m:perf  joy 45 sadness 0 anger 0 fear 0 amazement 0 disgust 0
відгук	                                         відгук                                                                       noun:m:v_zna  joy 15 sadness 0 anger 0 fear 0 amazement 0 disgust 0
Алекса	                                         Алекс                                                                         noun:m:v_rod:anim:fname joy 2 sadness 0 anger 0 fear 0 amazement 0 disgust 0
і	                                          і                                                                                conj:coord  joy 2 sadness 0 anger 0 fear 0 amazement 0 disgust 0
згадав	                                        згадати                                                                      verb:past:m:perf  joy 25 sadness 0 anger 0 fear 0 amazement 0 disgust 0
про	                                        про                                                                             prep:rv_zna  joy 0 sadness 0 anger 0 fear 0 amazement 0 disgust 0
власні	                                        власний                                                                      adj:p:v_zna joy 15 sadness 0 anger 0 fear 0 amazement 0 disgust 0
відвідини	                                        відвідини                                                                     noun:p:v_zna  joy 45 sadness 0 anger 0 fear 0 amazement 0 disgust 0
ресторану	                        ресторан                                                                     noun:m:v_rod joy 75 sadness 0 anger 0 fear 0 amazement 0 disgust 0
навесні	                                        навесні                                                                         adv  joy 80 sadness 0 anger 0 fear 0 amazement 0 disgust 0
цього	                                        цей                                                                                pron:dem                                               ( pron:dem:s:m:v_naz) joy 0 sadness 0 anger 0 fear 0 amazement 0 disgust 0
 року	                                        рік                                                                                 noun:m:v_rod joy 0 sadness 0 anger 0 fear 0 amazement 0 disgust 0
Прийшли	                                        прийти                                                                               verb:past:p:perf  joy 30 sadness 0 anger 0 fear 0 amazement 0 disgust 0
ми	                                        ми                                                                                      pron:pers:p:1:v_naz:anim  joy 0 sadness 0 anger 0 fear 0 amazement 0 disgust 0
туди	                                        туди                                                                                   adv joy 0 sadness 0 anger 0 fear 0 amazement 0 disgust 0
своєю	                                        свій                                                                                    pron:pos                                                 (pron:pos:s:f:v_oru) joy 0 sadness 0 anger 0 fear 0 amazement 0 disgust 0
компанією	                        компанія                                                                            noun:f:v_oru                                           ( noun:f:s:v_oru) joy 60 sadness 0 anger 0 fear 0 amazement 0 disgust 0
ресторан             	                        ресторан                                                                           noun:m:v_naz                                           ( noun:m:s:v_naz)  joy 60 sadness 0 anger 0 fear 0 amazement 0 disgust 0
був	                                        бути                                                                                   verb:past:m:imperf  joy 0 sadness 0 anger 0 fear 0 amazement 0 disgust 0
нам	                                        ми                                                                                       pron:pers:p:1:v_dav:anim  joy 0 sadness 0 anger 0 fear 0 amazement 0 disgust 0
рекомендований	                        рекомендований                                                               adjp:pasv:pres:past:m:v_naz joy 60 sadness 0 anger 0 fear 0 amazement 0 disgust 0
 з	                                        з                                                                                             prep:rv_oru  joy 0 sadness 0 anger 0 fear 0 amazement 0 disgust 0
собою	                                        себе                                                                                       pron:refl:m:v_oru  joy 0 sadness 0 anger 0 fear 0 amazement 0 disgust 0
ми	                                        ми                                                                                          pron:pers:p:1:v_naz:anim  joy 0 sadness 0 anger 0 fear 0 amazement 0 disgust 0
мали	                                        мати                                                                                      verb:past:p:imperf  joy 0 sadness 0 anger 0 fear 0 amazement 0 disgust 0
ключик	                                        ключик                                                                                    noun:m:v_zna                                         (noun:m:s:v_zna)  joy 45 sadness 0 anger 0 fear 0 amazement 18 disgust 0
тому	                                         тому                                                                                         conj:subord   joy 0 sadness 0 anger 0 fear 0 amazement 0 disgust 0
особливих	                         особливий                                                                                adj:p:v_zna  joy 60 sadness 0 anger 0 fear 0 amazement 0 disgust 0
сюрпризів	                         сюрприз                                                                                   noun:p:v_rod                                           joy 60 sadness 0 anger 0 fear 0 amazement 40 disgust 0
не	                                         не                                                                                              part  joy 0 sadness 0 anger 0 fear 0 amazement 0 disgust 0
очікували	                         очікувати                                                                                  verb:past:p:imperf  joy 45 sadness 0 anger 0 fear 0 amazement 0 disgust 0
Усі	                                         увесь                                                                                           pron:dem                                          ( pron:dem:p:v_naz) joy 0 sadness 0 anger 0 fear 0 amazement 0 disgust 0
були	                                         бути                                                                                             verb:past:p:imperf  joy 0 sadness 0 anger 0 fear 0 amazement 0 disgust 0
в	                                         в                                                                                                   prep:rv_mis:v-u  joy 0 sadness 0 anger 0 fear 0 amazement 0 disgust 0
хорошому	                         хороший                                                                                       adj:m:v_mis:compb  joy 76 sadness 0 anger 0 fear 0 amazement 0 disgust 0
настрої	                                         настрій                                                                                         noun:m:v_mis  joy 61 sadness 0 anger 0 fear 0 amazement 0 disgust 0
на	                                           на                                                                                               prep:rv_zna joy 0 sadness 0 anger 0 fear 0 amazement 0 disgust 0
огріхи	                                           огріх                                                                                           noun:p:v_zna joy 0 sadness 63 anger 0 fear 0 amazement 0 disgust 0
у	                                           у                                                                                                 prep:rv_mis:v-u  joy 0 sadness 1 anger 0 fear 0 amazement 0 disgust 0
роботі	                                           робота                                                                                        noun:f:v_mis                                    ( noun:f:s:v_mis) joy 32 sadness 0 anger 0 fear 0 amazement 0 disgust 0
закладу	                                           заклад                                                                                        noun:m:v_mis                                   (noun:m:s:v_mis) joy 47 sadness 0 anger 0 fear 0 amazement 0 disgust 0
вирішили	                                           вирішити                                                                                     verb:past:p:perf  joy 15 sadness 0 anger 0 fear 0 amazement 0 disgust 0
не	                                           не                                                                                                part  joy 0 sadness 0 anger 0 fear 0 amazement 0 disgust 0
звертати	                                           звертати                                                                                     verb:inf:imperf  joy 0 sadness 0 anger 0 fear 0 amazement 0 disgust 0
уваги	                                           увага                                                                                           noun:f:v_rod                                        joy 36 sadness 0 anger 0 fear 0 amazement 0 disgust 0
Проте	                                            проте                                                                                            insert  joy 0 sadness 0 anger 0 fear 0 amazement 0 disgust 0
їх	                                            вони                                                                                              pron:pers:p:3:v_zna:anim joy 0 sadness 0 anger 0 fear 0 amazement 0 disgust 0
було	                                            бути                                                                                               verb:past:n:imperf  joy 0 sadness 0 anger 0 fear 0 amazement 0 disgust 0
настільки	                                            настільки                                                                                       adv  joy 28 sadness 0 anger 0 fear 0 amazement 0 disgust 0
багато	                                            багато                                                                                            adv  joy 62 sadness 0 anger 0 fear 0 amazement 0 disgust 0
що	                                            що                                                                                                    conj:subord  joy 3 sadness 0 anger 0 fear 0 amazement 0 disgust 0
згодом	                                            згодом                                                                                             adv  joy 3 sadness 0 anger 0 fear 0 amazement 0 disgust 0
не	                                            не                                                                                                     part  joy 0 sadness 0 anger 0 fear 0 amazement 0 disgust 0
зважати	                                            зважати                                                                                            verb:inf:imperf  joy 0 sadness 0 anger 0 fear 0 amazement 0 disgust 0
на	                                            на                                                                                                      prep:rv_mis  joy 0 sadness 0 anger 0 fear 0 amazement 0 disgust 0
них	                                            вони                                                                                                   pron:pers:p:3:v_mis:anim joy 0 sadness 0 anger 0 fear 0 amazement 0 disgust 0
ми	                                            ми                                                                                                      pron:pers:p:1:v_naz:anim joy 0 sadness 0 anger 0 fear 0 amazement 0 disgust 0
вже	                                            вже                                                                                                   adv:v-u  joy 0 sadness 0 anger 0 fear 0 amazement 0 disgust 0
просто	                                            просто                                                                                              adv:compb  joy 0 sadness 0 anger 0 fear 0 amazement 0 disgust 0
не	                                            не                                                                                                       part  joy 0 sadness 0 anger 0 fear 0 amazement 0 disgust 0
могли	                                            могти                                                                                                 verb:unknown                               (verb:past:p:imperf) joy 0 sadness 0 anger 0 fear 0 amazement 0 disgust 0
Обслуговувати	                          обслуговувати                                                                                    verb:inf:imperf  joy 36 sadness 0 anger 0 fear 0 amazement 0 disgust 0
нас	                                          ми                                                                                                         pron:pers:p:1:v_zna:anim joy 1 sadness 0 anger 0 fear 0 amazement 0 disgust 0
почати                                                почати                                                                                              verb:past:m:perf  joy 16 sadness 0 anger 0 fear 0 amazement 0 disgust 0
один	                                          один                                                                                                      numr:m:v_naz  joy 0 sadness 17 anger 0 fear 0 amazement 0 disgust 0
офіціант	                                          офіціант                                                                                                noun:m:v_naz:anim  joy 30 sadness 0 anger 0 fear 0 amazement 0 disgust 0
продовжував	                         продовжувати                                                                                        verb:past:m:imperf  joy 16 sadness 0 anger 0 fear 0 amazement 0 disgust 0
другий	                                         другий                                                                                                     adj:m:v_naz  joy 0 sadness 0 anger 0 fear 0 amazement 0 disgust 0
а	                                         а                                                                                                                 conj:coord  joy 0 sadness 0 anger 0 fear 0 amazement 0 disgust 0
закінчував	                         закінчувати                                                                                               verb:past:m:imperf  joy 0 sadness 37 anger 0 fear 0 amazement 0 disgust 0
уже	                                         уже                                                                                                             adv:v-u  joy 0 sadness 1 anger 0 fear 0 amazement 0 disgust 0
фактично	                         фактично                                                                                                    adv  joy 0 sadness 0 anger 0 fear 0 amazement 0 disgust 0
третій	                                        третій                                                                                                           adj:m:v_zna  joy 0 sadness 0 anger 0 fear 0 amazement 0 disgust 0
Цей	                                         цей                                                                                                                 pron:dem                            (pron:dem:s:m:v_naz)  joy 0 sadness 0 anger 0 fear 0 amazement 0 disgust 0
третій	                                        третій                                                                                                              adj:m:v_naz  joy 0 sadness 0 anger 0 fear 0 amazement 0 disgust 0
 був	                                        бути                                                                                                                verb:past:m:imperf  joy 0 sadness 0 anger 0 fear 0 amazement 0 disgust 0
очевидно	                      очевидно                                                                                                          insert  joy 23 sadness 0 anger 0 fear 0 amazement 0 disgust 0
стажером	                     стажер                                                                                                               noun:m:v_oru:bad:anim  joy 0 sadness 25 anger 0 fear 0 amazement 0 disgust 0
і	                                       і                                                                                                                         conj:coord  joy 0 sadness 0 anger 0 fear 0 amazement 0 disgust 0
навчали	                                      навчати                                                                                                             verb:past:p:imperf  joy 35 sadness 0 anger 0 fear 0 amazement 0 disgust 0
його	                                      він                                                                                                                      pron:pos                                  (pron:pos:m:s:v_zna) joy 0 sadness 0 anger 0 fear 0 amazement 0 disgust 0
за	                                      за                                                                                                                       prep:rv_oru joy 0 sadness 0 anger 0 fear 0 amazement 0 disgust 0
нашим	                                      наш                                                                                                                     pron:pos                                  (pron:pos:m:s:v_oru) joy 0 sadness 0 anger 0 fear 0 amazement 0 disgust 0
столом	                                     стіл                                                                                                                      noun:m:v_oru                         ( noun:m:s:v_oru)  joy 0 sadness 0 anger 0 fear 0 amazement 0 disgust 0
Усі	                                     увесь                                                                                                                pron:dem                              (pron:dem:p:v_naz)      joy 0 sadness 0 anger 0 fear 0 amazement 0 disgust 0
салати	                                    салат                                                                                                                 noun:p:v_naz  joy 76 sadness 0 anger 0 fear 0 amazement 0 disgust 0
були	                                    бути                                                                                                                   verb:past:p:imperf  joy 1 sadness 0 anger 0 fear 0 amazement 0 disgust 0
заправлені	                    заправлений                                                                                                     adjp:pasv:past:p:v_naz  joy 15 sadness 0 anger 0 fear 0 amazement 0 disgust 0
майонезом	                   майонез                                                                                                               noun:m:v_oru  joy 0 sadness 42 anger 0 fear 0 amazement 0 disgust 0
ніби	                                   ніби                                                                                                                       conj:subord  joy 0 sadness 3 anger 0 fear 0 amazement 0 disgust 0
жодних	                                   жодний                                                                                                                   pron                           ( pron:p:v_rod) joy 0 sadness 46 anger 0 fear 0 amazement 0 disgust 0
інших	                                    інший                                                                                                                     pron:def  joy 0 sadness 0 anger 0 fear 0 amazement 0 disgust 0
приправ	                                   приправа                                                                                                               noun:p:v_rod              (noun:p:v_zna) joy 46 sadness 0 anger 0 fear 0 amazement 0 disgust 0
на	                                   на                                                                                                                   prep:rv_mis  joy 0 sadness 0 anger 0 fear 0 amazement 0 disgust 0
кухні	                                   кухня                                                                                                              noun:f:v_mis joy 30 sadness 0 anger 0 fear 0 amazement 0 disgust 0
не	                                   не                                                                                                                   part  joy 0 sadness 0 anger 0 fear 0 amazement 0 disgust 0
було	                                   бути                                                                                                               verb:past:n:imperf  joy 0 sadness 0 anger 0 fear 0 amazement 0 disgust 0
а	                                   а                                                                                                                    conj:coord  joy 0 sadness 0 anger 0 fear 0 amazement 0 disgust 0
фантазії	                                  фантазія                                                                                                        noun:f:v_rod joy 73 sadness 0 anger 0 fear 0 amazement 47 disgust 0
кухарів	                                   кухар                                                                                                             noun:p:v_rod:anim  joy 15 sadness 0 anger 0 fear 0 amazement 0 disgust 0
вистачило	                  вистачити                                                                                                      verb:past:n:perf  joy 30 sadness 0 anger 0 fear 0 amazement 0 disgust 0
лише	                                  лише                                                                                                                part  joy 0 sadness 0 anger 0 fear 0 amazement 0 disgust 0
на	                                  на                                                                                                                    prep:rv_mis  joy 0 sadness 0 anger 0 fear 0 amazement 0 disgust 0
те	                                  той                                                                                                                  pron:dem                                    (pron:dem:n:s:v_naz)                                   joy 0 sadness 0 anger 0 fear 0 amazement 0 disgust 0
щоб	                                  щоб                                                                                                                  conj:subord  joy 0 sadness 0 anger 0 fear 0 amazement 0 disgust 0
прикрасити	                   прикрасити                                                                                                   verb:inf:perf  joy 62 sadness 0 anger 0 fear 0 amazement 0 disgust 0
їх	                                   вони                                                                                                              pron:pers:p:3:v_zna:anim joy 0 sadness 0 anger 0 fear 0 amazement 0 disgust 0
яйцями	                                    яйце                                                                                                              noun:p:v_oru  joy 25 sadness 0 anger 0 fear 0 amazement 0 disgust 0
порізаними	                    порізаний                                                                                                     adjp:pasv:past:p:v_oru  joy 0 sadness 37 anger 0 fear 0 amazement 0 disgust 0
на	                                    на                                                                                                                  prep:rv_zna joy 0 sadness 0 anger 0 fear 0 amazement 0 disgust 0
чотири	                                    чотири                                                                                                           numr:p:v_zna joy 0 sadness 0 anger 0 fear 0 amazement 0 disgust 0
частини	                                     частина                                                                                                         noun:f:v_zna  joy 0 sadness 0 anger 0 fear 0 amazement 0 disgust 0
Стейки	                                           стейк                                                                                                        noun:p:v_naz  joy 60 sadness 0 anger 0 fear 0 amazement 0 disgust 0
 які	                                             який                                                                                                      pron:int:rel:def                  (pron:int:rel:def:p:v_naz) joy 13 sadness 0 anger 0 fear 0 amazement 0 disgust 0
були	                                             бути                                                                                                       verb:past:p:imperf  joy 14 sadness 0 anger 0 fear 0 amazement 0 disgust 0
нам	                                             ми                                                                                                           pron:pers:p:1:v_dav:anim  joy 0 sadness 0 anger 0 fear 0 amazement 0 disgust 0
наполегливо	                             наполегливо                                                                                          adv:compb  joy 41 sadness 0 anger 0 fear 0 amazement 0 disgust 0
рекомендовані	                             рекомендований                                                                                    adjp:pasv:pres:past:p:v_naz  joy 30 sadness 0 anger 0 fear 0 amazement 0 disgust 0
виявилися	                             виявитися                                                                                              verb:rev:past:p:perf  joy 16 sadness 0 anger 0 fear 0 amazement 0 disgust 0
якимись	                                             якийсь                                                                                                     pron:ind                           ( pron:ind:p:v_oru) joy 0 sadness 0 anger 0 fear 0 amazement 0 disgust 0
напівсирими	                             напівсирий                                                                                              adj:p:v_oru  joy 0 sadness 62 anger 0 fear 0 amazement 0 disgust 0
м'язами	                                              м'яз                                                                                                         noun:p:v_oru  joy 0 sadness 27 anger 0 fear 0 amazement 0 disgust 33
іншого	                                              інший                                                                                                     pron:def                               (pron:def:m:s:v_rod) joy 0 sadness 0 anger 0 fear 0 amazement 0 disgust 0
порівняння	                            порівняння                                                                                              noun:n:v_naz                         joy 16 sadness 0 anger 0 fear 0 amazement 0 disgust 0
я	                                             я                                                                                                              pron:pers:s:1:v_naz:anim  joy 0 sadness 0 anger 0 fear 0 amazement 0 disgust 0
просто	                                            просто                                                                                                     adv:compb  joy 0 sadness 0 anger 0 fear 0 amazement 0 disgust 0
не	                                             не                                                                                                           part  joy 0 sadness 0 anger 0 fear 0 amazement 0 disgust 0
можу	                                             могти                                                                                                      verb:unknown                      (verb:pres:1:s:imperf) joy 0 sadness 0 anger 0 fear 0 amazement 0 disgust 0
знайти	                                             знайти                                                                                                    verb:inf:perf  joy 30 sadness 0 anger 0 fear 0 amazement 0 disgust 0
Замовили	                               замовити                                                                                          verb:past:p:perf  joy 29 sadness 0 anger 0 fear 0 amazement 0 disgust 0
ми	                                              ми                                                                                                        pron:pers:p:1:v_naz:anim joy 0 sadness 0 anger 0 fear 0 amazement 0 disgust 0
їх	                                              вони                                                                                                    pron:pers:p:3:v_zna:anim joy 0 sadness 0 anger 0 fear 0 amazement 0 disgust 0
тож	                                            тож                                                                                                           conj:subord  joy 0 sadness 0 anger 0 fear 0 amazement 0 disgust 0
уявляю	                                           уявляти                                                                                                      verb:pres:s:1:imperf  joy 30 sadness 0 anger 0 fear 0 amazement 0 disgust 0
що	                                           що                                                                                                               pron:int:rel:n:v_naz  joy 0 sadness 0 anger 0 fear 0 amazement 0 disgust 0
б	                                           б                                                                                                                  part  joy 0 sadness 0 anger 0 fear 0 amazement 0 disgust 0
нам	                                           ми                                                                                                                pron:pers:p:1:v_dav:anim joy 0 sadness 0 anger 0 fear 0 amazement 0 disgust 0
принесли         	                           принести                                                                                                     verb:past:p:perf  joy 30 sadness 0 anger 0 fear 0 amazement 0 disgust 0
якби	                                         якби                                                                                                               conj:subord  joy 0 sadness 0 anger 0 fear 0 amazement 0 disgust 0
ми	                                         ми                                                                                                                  pron:pers:p:1:v_naz:anim joy 0 sadness 0 anger 0 fear 0 amazement 0 disgust 0
замовили	                         замовити                                                                                                       verb:past:p:perf  joy 24 sadness 0 anger 0 fear 0 amazement 0 disgust 0
їх	                                         вони                                                                                                               pron:pers:p:3:v_rod:anim joy 0 sadness 0 anger 0 fear 0 amazement 0 disgust 0
З	                                            з                                                                                                                    prep:rv_rod joy 0 sadness 0 anger 0 fear 0 amazement 0 disgust 0
усього	                                           увесь                                                                                                              pron:dem                           (pron:dem:m:s:v_rod) joy 0 sadness 0 anger 0 fear 0 amazement 0 disgust 0
замовленого	                           замовлений                                                                                                   adjp:pasv:past:n:v_rod  joy 31 sadness 0 anger 0 fear 0 amazement 0 disgust 0
усім	                                          увесь                                                                                                                pron:dem                            (pron:dem:p:v_dav) joy 25 sadness 0 anger 0 fear 0 amazement 0 disgust 0
сподобалося	                          сподобатися                                                                                                     verb:rev:past:n:perf  joy 59 sadness 0 anger 0 fear 0 amazement 0 disgust 0
лише	                                          лише                                                                                                                  part  joy 1 sadness 0 anger 0 fear 0 amazement 0 disgust 0
вино	                                          вино                                                                                                                  noun:n:v_zna  joy 53 sadness 0 anger 0 fear 0 amazement 0 disgust 0
але	                                           але                                                                                                                   conj:coord  joy 0 sadness 0 anger 0 fear 0 amazement 0 disgust 0
заслуги	                                           заслуга                                                                                                           noun:f:v_rod  joy 66 sadness 0 anger 0 fear 0 amazement 0 disgust 0
закладу                	                          заклад                                                                                                               noun:m:v_rod                        (noun:m:s:v_rod) joy 15 sadness 0 anger 0 fear 0 amazement 0 disgust 0
у	                                            у                                                                                                                        prep:rv_mis:v-u  joy 0 sadness 0 anger 0 fear 0 amazement 0 disgust 0
цьому	                                          цей                                                                                                                      pron:dem                              (pron:dem:m:s:v_mis)  joy 0 sadness 0 anger 0 fear 0 amazement 0 disgust 0
не	                                          не                                                                                                                         part  joy 0 sadness 0 anger 0 fear 0 amazement 0 disgust 0
було	                                         бути                                                                                                                     verb:past:n:imperf  joy 0 sadness 0 anger 0 fear 0 amazement 0 disgust 0
жодної	                                         жодний                                                                                                                pron                                         (pron:f:s:v_rod)  joy 0 sadness 0 anger 0 fear 0 amazement 0 disgust 0
Проголосити	                         проголосити                                                                       verb:inf:perf  joy 30 sadness 0 anger 0 fear 0 amazement 0 disgust 0
себе	                                          себе                                                                                   pron:refl:m:v_rod   joy 0 sadness 0 anger 0 fear 0 amazement 0 disgust 0
найдорожчим	                         дорогий                                                                               adj:m:v_oru:super  joy 45 sadness 0 anger 0 fear 0 amazement 0 disgust 0
рестораном	                        ресторан                                                                              noun:m:v_oru  joy 65 sadness 0 anger 0 fear 0 amazement 0 disgust 0
Галичини	                                        Галичина                                                                              noun:f:v_rod  joy 57 sadness 0 anger 0 fear 0 amazement 0 disgust 0
дуже	                                         дуже                                                                                     adv joy 69 sadness 0 anger 0 fear 0 amazement 0 disgust 0
просто	                                         просто                                                                                adv:compb  joy 69 sadness 0 anger 0 fear 0 amazement 0 disgust 0
А	                                       а                                                                                  part  joy 0 sadness 0 anger 0 fear 0 amazement 0 disgust 0
чому	                                       що                                                                                pron:int:rel:n:v_dav  joy 0 sadness 0 anger 0 fear 0 amazement 0 disgust 0
не	                                       не                                                                                  part  joy 0 sadness 0 anger 0 fear 0 amazement 0 disgust 0
позиціонувати	                       позиціонувати                                                             verb:inf:bad  joy 30 sadness 0 anger 0 fear 0 amazement 0 disgust 0
себе	                                       себе                                                                               pron:refl:m:v_rod joy 0 sadness 0 anger 0 fear 0 amazement 0 disgust 0
рестораном	                      ресторан                                                                        noun:m:v_oru  joy 75 sadness 0 anger 0 fear 0 amazement 0 disgust 0
з	                                       з                                                                                     prep:rv_oru  joy 0 sadness 0 anger 0 fear 0 amazement 0 disgust 0
найвищим	                      високий                                                                          adj:m:v_oru:super  joy 74 sadness 0 anger 0 fear 0 amazement 0 disgust 0
рівнем	                                        рівень                                                                             noun:m:v_oru  joy 30 sadness 0 anger 0 fear 0 amazement 0 disgust 0
обслуговування	                        обслуговування                                                             noun:n:v_rod joy 45 sadness 0 anger 0 fear 0 amazement 0 disgust 0
чи	                                      чи                                                                                      conj:coord joy 0 sadness 0 anger 0 fear 0 amazement 0 disgust 0
найкращою	                      хороший                                                                             adj:f:v_oru:super  joy 75 sadness 0 anger 0 fear 0 amazement 0 disgust 0
кухнею	                                      кухня                                                                                   noun:f:v_oru  joy 15 sadness 0 anger 0 fear 0 amazement 0 disgust 0
у	                                      у                                                                                          prep:rv_mis:v-u  joy 10 sadness 0 anger 0 fear 0 amazement 0 disgust 0
Галичині	                                      Галичина                                                                             noun:f:v_mis  joy 75 sadness 0 anger 0 fear 0 amazement 0 disgust 0
Чи	                                        чи                                     conj:coord joy 0 sadness 0 anger 0 fear 0 amazement 0 disgust 0
може	                                       може                                   insert  joy 2 sadness 0 anger 0 fear 0 amazement 0 disgust 0
власники	                                      власник                               noun:p:v_naz:anim  joy 15 sadness 0 anger 0 fear 0 amazement 0 disgust 0
мережі	                                       мережа                                noun:f:v_rod joy 14 sadness 0 anger 0 fear 0 amazement 0 disgust 0
ніколи	                                        ніколи                                  pron:neg  joy 0 sadness 51 anger 0 fear 0 amazement 0 disgust 0
не	                                        не                                          part  joy 0 sadness 0 anger 0 fear 0 amazement 0 disgust 0
бували	                                        бувати                                verb:past:p:imperf  joy 29 sadness 0 anger 0 fear 0 amazement 0 disgust 0
далі	                                       далі                                        adv  joy 0 sadness 0 anger 0 fear 0 amazement 0 disgust 0
Польщі	                                      Польща                                 noun:f:v_rod joy 15 sadness 0 anger 0 fear 0 amazement 0 disgust 0
і	                                         і                                           conj:coord  joy 0 sadness 0 anger 0 fear 0 amazement 0 disgust 0
не	                                         не                                         part  joy 0 sadness 0 anger 0 fear 0 amazement 0 disgust 0
знають	                                        знати                                    verb:pres:p:3:imperf  joy 19 sadness 0 anger 0 fear 0 amazement 0 disgust 0
що	                                         що                                         pron:int:rel:n:v_naz  joy 0 sadness 0 anger 0 fear 0 amazement 0 disgust 0
у	                                           у                                          prep:rv_mis:v-u  joy 0 sadness 0 anger 0 fear 0 amazement 0 disgust 0
ресторані	                       ресторан                                 noun:m:v_mis  joy 61 sadness 0 anger 0 fear 0 amazement 0 disgust 0
все	                                       весь                                         adv:v-u  joy 0 sadness 0 anger 0 fear 0 amazement 0 disgust 0
починається	                      починатися                               verb:rev:pres:s:3:imperf  joy 45 sadness 0 anger 0 fear 0 amazement 0 disgust 0
з	                                      з                                                 prep:rv_rod  joy 0 sadness 0 anger 0 fear 0 amazement 0 disgust 0
кухні	                                      кухня                                          noun:f:v_rod joy 60 sadness 0 anger 0 fear 0 amazement 0 disgust 0
та	                                        та                                               conj:coord  joy 0 sadness 0 anger 0 fear 0 amazement 0 disgust 0
сервісу	                                        сервіс                                        noun:m:v_rod joy 60 sadness 0 anger 0 fear 0 amazement 0 disgust 0
а	                                         а                                              conj:coord  joy 0 sadness 0 anger 0 fear 0 amazement 0 disgust 0
не	                                         не                                             part  joy 0 sadness 0 anger 0 fear 0 amazement 0 disgust 0
з	                                          з                                              prep:rv_rod joy 0 sadness 0 anger 0 fear 0 amazement 0 disgust 0
інтер'єру 	                        інтер'єр                                    noun:m:v_rod joy 60 sadness 0 anger 0 fear 0 amazement 0 disgust 0
                                                       noun:m:v_mis  joy 0 sadness 0 anger 0 fear 0 amazement 0 disgust 0
                                                       noun:m:v_rod  joy 0 sadness 0 anger 0 fear 0 amazement 0 disgust 0
Пропоную	пропонувати                     verb:pres:s:1:imperf  joy 30 sadness 0 anger 0 fear 0 amazement 0 disgust 0
їм	                вони                                   pron:pers:p:3:v_dav:anim joy 0 sadness 0 anger 0 fear 0 amazement 0 disgust 0
проводити	проводити                         verb:inf:imperf joy 30 sadness 0 anger 0 fear 0 amazement 0 disgust 0
тренінги	               тренінг                               noun:p:v_zna joy 25 sadness 0 anger 0 fear 0 amazement 0 disgust 0
для	                 для                                   prep:rv_rod  joy 0 sadness 0 anger 0 fear 0 amazement 0 disgust 0
своїх	                 свій                                   pron:pos                     (pron:pos:p:v_rod)        joy 0 sadness 0 anger 0 fear 0 amazement 0 disgust 0
офіціантів	офіціант                             noun:p:v_rod:anim  joy 46 sadness 0 anger 0 fear 0 amazement 0 disgust 0
 на	                на                                       prep:rv_mis  joy 3 sadness 0 anger 0 fear 0 amazement 0 disgust 0
власних	                власний                             adj:p:v_mis  joy 3 sadness 0 anger 0 fear 0 amazement 0 disgust 0
забавах      	забава                              noun:p:v_mis  joy 53 sadness 0 anger 0 fear 0 amazement 0 disgust 0
та	                 та                                     conj:coord  joy 0 sadness 0 anger 0 fear 0 amazement 0 disgust 0
днях	                день                                   noun:p:v_mis  joy 0 sadness 0 anger 0 fear 0 amazement 0 disgust 0
народження	народження                       noun:n:v_rod                    joy 29 sadness 0 anger 0 fear 0 amazement 0 disgust 0
Тоді	                      тоді                                        adv  joy 35 sadness 0 anger 0 fear 0 amazement 0 disgust 0
можливо	                     можливо                                 adv                   (insert) joy 17 sadness 0 anger 0 fear 0 amazement 0 disgust 0
якість	                      якість                                     noun:f:v_naz  joy 0 sadness 0 anger 0 fear 0 amazement 0 disgust 0
обслуговування	     обслуговування                     noun:n:v_rod joy 25 sadness 0 anger 0 fear 0 amazement 0 disgust 0
 у	                       у                                              prep:rv_rod:v-u  joy 0 sadness 0 anger 0 fear 0 amazement 0 disgust 0
нас	                      ми                                             pron:pers:p:1:v_rod:anim  joy 0 sadness 0 anger 0 fear 0 amazement 0 disgust 0
поступово	      поступово                                 adv  joy 16 sadness 0 anger 0 fear 0 amazement 0 disgust 0
і	                        і                                               conj:coord  joy 0 sadness 0 anger 0 fear 0 amazement 0 disgust 0
зміниться	        змінитися                              verb:rev:futr:s:3:perf  joy 24 sadness 0 anger 0 fear 0 amazement 0 disgust 0
на	                          на                                        prep:rv_zna joy 1 sadness 0 anger 0 fear 0 amazement 0 disgust 0
краще	                          хороший                              adj:n:v_zna:compr  joy 34 sadness 0 anger 0 fear 0 amazement 0 disgust 0
Висловлюю	висловлювати         verb:pres:s:1:imperf  joy 16 sadness 0 anger 0 fear 0 amazement 0 disgust 0
подяку	                подяка                      noun:f:v_zna  joy 67 sadness 0 anger 0 fear 0 amazement 0 disgust 0
піаністу	                піаніст                       noun:m:v_dav:anim  joy 81 sadness 0 anger 0 fear 0 amazement 0 disgust 0
Класна	            класний                      adj:f:v_naz  joy 73 sadness 0 anger 0 fear 0 amazement 0 disgust 0
музика	           музика                        noun:f:v_naz  joy 83 sadness 0 anger 0 fear 0 amazement 0 disgust 0
Без	                  без                        prep:rv_rod  joy 0 sadness 0 anger 0 fear 0 amazement 0 disgust 0
нього	                  він                         pron:pers:m:3:v_rod:anim  joy 0 sadness 0 anger 0 fear 0 amazement 0 disgust 0
в	                   в                           prep:rv_mis:v-u  joy 0 sadness 0 anger 0 fear 0 amazement 0 disgust 0
Масонах	                   масон                     noun:p:v_mis:anim  joy 63 sadness 0 anger 0 fear 17 amazement 15 disgust 0
було	                  бути                        verb:past:n:imperf  joy 0 sadness 0 anger 0 fear 0 amazement 0 disgust 0
б	                  б                              part  joy 0 sadness 0 anger 0 fear 0 amazement 0 disgust 0
дуже	                  дуже                        adv  joy 62 sadness 0 anger 0 fear 0 amazement 0 disgust 0
сумно	                 сумно                        adv:compb  joy 0 sadness 84 anger 0 fear 0 amazement 0 disgust 0
 на	                                           на                                                                                                                  prep:rv_zna joy 0 sadness 0 anger 0 fear 0 amazement 0 disgust 0
даний	                                           даний                                                                                                            adjp:pasv:past:m:v_zna joy 0 sadness 0 anger 0 fear 0 amazement 0 disgust 0
момент	                                            момент                                                                                                         noun:m:v_zna joy 0 sadness 0 anger 0 fear 0 amazement 0 disgust 0
я	                                             я                                                                                                                   pron:pers:s:1:v_naz:anim  joy 0 sadness 0 anger 0 fear 0 amazement 0 disgust 0
зі	                                             зі                                                                                                                  prep:rv_oru  joy 0 sadness 0 anger 0 fear 0 amazement 0 disgust 0
своєю	                                           свій                                                                                                                pron:pos                                    (pron:pos:f:s:v_oru) joy 0 sadness 0 anger 0 fear 0 amazement 0 disgust 0
коханою	                                           кохана                                                                                                            noun:f:v_oru:anim joy 79 sadness 0 anger 0 fear 0 amazement 0 disgust 0
дружиною	                           дружина                                                                                                          noun:f:v_oru                            ( noun:f:s:v_oru)  joy 0 sadness 0 anger 0 fear 0 amazement 0 disgust 0
знаходимося	                          знаходитися                                                                                                    verb:rev:pres:p:1:imperf  joy 81 sadness 0 anger 0 fear 0 amazement 0 disgust 0
в	                                          в                                                                                                                       prep:rv_mis:v-u  joy 0 sadness 0 anger 0 fear 0 amazement 0 disgust 0
цьому	                                         цей                                                                                                                    pron:dem                               (pron:dem:m:s:v_mis) joy 0 sadness 0 anger 0 fear 0 amazement 0 disgust 0
чудовому	                          чудовий                                                                                                            adj:n:v_mis:compb  joy 73 sadness 0 anger 0 fear 0 amazement 0 disgust 0
місці	                                           місце                                                                                                                 noun:n:v_mis                        (noun:n:s:v_mis)  joy 0 sadness 0 anger 0 fear 0 amazement 0 disgust 0
Обстановка	                                обстановка                                                       noun:f:v_naz  joy 14 sadness 0 anger 0 fear 0 amazement 0 disgust 0
просто	                                                просто                                                               adv:compb  joy 0 sadness 0 anger 0 fear 0 amazement 0 disgust 0
дивовижна	                               дивовижний                                                       adj:f:v_naz:compb  joy 89 sadness 0 anger 0 fear 0 amazement 0 disgust 0
офіціант	                                                офіціант                                                              noun:m:v_naz:anim                                   ( noun:m:s:v_naz:anim) joy 30 sadness 0 anger 0 fear 0 amazement 0 disgust 0
зустрів	                                                зустріти                                                              verb:past:m:perf  joy 15 sadness 0 anger 0 fear 0 amazement 0 disgust 0
на	                                                на                                                                        prep:rv_mis  joy 0 sadness 0 anger 0 fear 0 amazement 0 disgust 0
вході	                                                 вхід                                                                     noun:m:v_mis  joy 15 sadness 0 anger 0 fear 0 amazement 0 disgust 0
провів	                                                провести                                                            verb:past:m:perf  joy 30 sadness 0 anger 0 fear 0 amazement 0 disgust 0
до	                                                до                                                                        prep:rv_rod  joy 0 sadness 0 anger 0 fear 0 amazement 0 disgust 0
вільного	                                                вільний                                                               adj:n:v_rod:compb  joy 45 sadness 0 anger 0 fear 0 amazement 0 disgust 0
місця	                                                місце                                                                   noun:n:v_rod  joy 16 sadness 0 anger 0 fear 0 amazement 0 disgust 0
дуже	                                               дуже                                                                      adv joy 60 sadness 0 anger 0 fear 0 amazement 0 disgust 0
чемний	                                              чемний                                                                   adj:m:v_naz:compb  joy 77 sadness 0 anger 0 fear 0 amazement 0 disgust 0
і	                                                і                                                                            conj:coord  joy 0 sadness 0 anger 0 fear 0 amazement 0 disgust 0
привітний	                              привітний                                                              adj:m:v_naz:compb  joy 80 sadness 0 anger 0 fear 0 amazement 0 disgust 0
Фішка	                                                фішка                                                                       noun:f:v_naz                                (noun:f:s:v_naz)  joy 31 sadness 0 anger 0 fear 0 amazement 0 disgust 0
з	                                                з                                                                              prep:rv_oru  joy 0 sadness 0 anger 0 fear 0 amazement 0 disgust 0
нулями	                                                нуль                                                                         noun:p:v_oru  joy 0 sadness 69 anger 0 fear 0 amazement 0 disgust 0
в	                                                в                                                                               prep:rv_mis:v-u  joy 0 sadness 0 anger 0 fear 0 amazement 0 disgust 0
рахунку                            	                рахунок                                                                   noun:m:v_mis                                (noun:m:s:v_mis)  joy 17 sadness 0 anger 0 fear 0 amazement 0 disgust 0
це	                                                цей                                                                           pron:dem                                        (pron:dem:n:s:v_naz) joy 0 sadness 0 anger 0 fear 0 amazement 0 disgust 0
і	                                                  і                                                                                part  joy 0 sadness 0 anger 0 fear 0 amazement 0 disgust 0
не	                                                  не                                                                             part  joy 0 sadness 0 anger 0 fear 0 amazement 0 disgust 0
більше	                                                  багато                                                                      adv:compr joy 14 sadness 0 anger 0 fear 0 amazement 0 disgust 0
ми	                                                  ми                                                                       pron:pers:p:1:v_naz:anim  joy 0 sadness 0 anger 0 fear 0 amazement 0 disgust 0
вже	                                                  вже                                                                     adv:v-u  joy 0 sadness 0 anger 0 fear 0 amazement 0 disgust 0
другий	                                                  другий                                                                adj:m:v_naz                                       (numb:m:s:v_naz) joy 0 sadness 0 anger 0 fear 0 amazement 0 disgust 0
раз	                                                 раз                                                                       noun:m:v_naz  joy 0 sadness 0 anger 0 fear 0 amazement 0 disgust 0
тут                                                           тут                                                                       adv  joy 0 sadness 0 anger 0 fear 0 amazement 0 disgust 0
і	                                                  і                                                                          conj:coord  joy 0 sadness 0 anger 0 fear 0 amazement 0 disgust 0
казусів	                                                 казус                                                                   noun:p:v_rod  joy 0 sadness 66 anger 0 fear 0 amazement 0 disgust 0
і	                                                  і                                                                           conj:coord  joy 0 sadness 0 anger 0 fear 0 amazement 0 disgust 0
нарікань	                                                 нарікання                                                             noun:p:v_rod  joy 0 sadness 72 anger 0 fear 0 amazement 0 disgust 0
на	                                                  на                                                                        prep:rv_zna joy 0 sadness 0 anger 0 fear 0 amazement 0 disgust 0
обслуговування	                                 обслуговування                                                  noun:n:v_naz  joy 18 sadness 0 anger 0 fear 0 amazement 0 disgust 0
не	                                                  не                                                                         part  joy 0 sadness 0 anger 0 fear 0 amazement 0 disgust 0
було	                                                  бути                                                                      verb:past:n:imperf  joy 0 sadness 0 anger 0 fear 0 amazement 0 disgust 0
Чудове	                                                 чудовий                                                                adj:n:v_naz:compb  joy 72 sadness 0 anger 0 fear 0 amazement 0 disgust 0
місце	                                                  місце                                                                     noun:n:v_naz                               (noun:n:s:v_naz) joy 33 sadness 0 anger 0 fear 0 amazement 0 disgust 0
радимо	                                                   радити                                                                verb:pres:p:1:imperf  joy 67 sadness 0 anger 0 fear 0 amazement 0 disgust 0
всім	                                                   весь                                                                     pron:dem                                       (pron:dem:p:v_rod) joy 0 sadness 0 anger 0 fear 0 amazement 0 disgust 0
Вчора	                                                вчора                                                                      adv:v-u  joy 0 sadness 20 anger 0 fear 0 amazement 0 disgust 0
ввечері	                                                ввечері                                                                   adv:v-u  joy 65 sadness 0 anger 0 fear 0 amazement 0 disgust 0
були	                                                бути                                                                        verb:past:p:imperf  joy 12 sadness 0 anger 0 fear 0 amazement 0 disgust 0
у                                                              у	                                                                prep:rv_mis:v-u  joy 12 sadness 0 anger 0 fear 0 amazement 0 disgust 0
ресторації	                                ресторація                                                              noun:f:v_mis  joy 68 sadness 0 anger 0 fear 0 amazement 0 disgust 0
з	                                               з                                                                                prep:rv_oru  joy 0 sadness 0 anger 0 fear 0 amazement 0 disgust 0
подругами	                               подруга                                                                    noun:p:v_oru:anim  joy 47 sadness 0 anger 0 fear 0 amazement 0 disgust 0
вирішили	                                                вирішити                                                                    verb:past:p:perf  joy 16 sadness 0 anger 0 fear 0 amazement 0 disgust 0
відмітити	                                                відмітити                                                                    verb:inf:perf  joy 32 sadness 0 anger 0 fear 0 amazement 0 disgust 0
останній	                                                останній                                                                     adj:m:v_zna joy 0 sadness 49 anger 0 fear 0 amazement 0 disgust 0
день	                                               день                                                                              noun:m:v_zna                                    (noun:m:s:v_zna) joy 0 sadness 0 anger 0 fear 0 amazement 0 disgust 0
у	                                                у                                                                                    prep:rv_mis:v-u  joy 0 sadness 0 anger 0 fear 0 amazement 0 disgust 0
Львові	                                                Львів                                                                            noun:m:v_mis  joy 47 sadness 0 anger 0 fear 0 amazement 0 disgust 0
самі	                                               сам                                                                                  pron:def                                            (pron:def:p:v_naz) joy 9 sadness 0 anger 0 fear 0 amazement 0 disgust 0
ж	                                               ж                                                                                     part  joy 9 sadness 0 anger 0 fear 0 amazement 0 disgust 0
з	                                               з                                                                                     prep:rv_rod  joy 9 sadness 0 anger 0 fear 0 amazement 0 disgust 0
Києва	                                               Київ                                                                                noun:m:v_rod  joy 43 sadness 0 anger 0 fear 0 amazement 0 disgust 0
Так	                                              так                                                                                    adv  joy 0 sadness 0 anger 0 fear 0 amazement 0 disgust 0
ось	                                              ось                                                                                    part  joy 0 sadness 0 anger 0 fear 0 amazement 0 disgust 0
Я	                                               я                                                                                       pron:pers:s:1:v_naz:anim  joy 0 sadness 0 anger 0 fear 0 amazement 0 disgust 0
У	                                               у                                                                                       prep :rv_mis:v-u  joy 0 sadness 0 anger 0 fear 0 amazement 0 disgust 0
ЗАХВАТІ	                                              захват                                                                               noun:m:v_mis  joy 75 sadness 0 anger 0 fear 0 amazement 0 disgust 0
Ніби	                                                 ніби                                                                                  part  joy 0 sadness 0 anger 0 fear 0 amazement 0 disgust 0
прості	                                                 простий                                                                           adj:p:v_naz:compb  joy 0 sadness 0 anger 0 fear 0 amazement 0 disgust 0
на	                                                 на                                                                                      prep:rv_zna joy 0 sadness 0 anger 0 fear 0 amazement 0 disgust 0
перший	                                                 перший                                                                              adj:m:v_zna joy 0 sadness 0 anger 0 fear 0 amazement 0 disgust 0
погляд	                                                 погляд                                                                              noun:m:v_zna joy 15 sadness 0 anger 0 fear 0 amazement 0 disgust 0
страви	                                                  страва                                                                              noun:p:v_zna joy 49 sadness 0 anger 0 fear 0 amazement 0 disgust 0
хоча	                                                  хоча                                                                                 conj:subord  joy 0 sadness 0 anger 0 fear 0 amazement 0 disgust 0
одна	                                                 один                                                                                  numr:f:v_naz  joy 0 sadness 0 anger 0 fear 0 amazement 0 disgust 0
з	                                                 з                                                                                        prep:rv_rod joy 0 sadness 0 anger 0 fear 0 amazement 0 disgust 0
подруг	                                                 подруга                                                                              noun:p:v_rod:anim  joy 45 sadness 0 anger 0 fear 0 amazement 0 disgust 0
за	                                                  за                                                                                      prep:rv_zna joy 0 sadness 0 anger 0 fear 0 amazement 0 disgust 0
рік	                                                  рік                                                                                      noun:m:v_zna                          (noun:m:s:v_zna)       joy 0 sadness 0 anger 0 fear 0 amazement 0 disgust 0
тільки	                                                 тільки                                                                                    adv  joy 0 sadness 0 anger 0 fear 0 amazement 0 disgust 0
там	                                                  там                                                                                       adv joy 0 sadness 0 anger 0 fear 0 amazement 0 disgust 0
знайшла	                                                  знайти                                                                              verb:past:f:perf  joy 41 sadness 0 anger 0 fear 0 amazement 0 disgust 0
так	                                                   так                                                                                   adv joy 0 sadness 0 anger 0 fear 0 amazement 0 disgust 0
добре	                                                   добре                                                                               adv  joy 65 sadness 0 anger 0 fear 0 amazement 0 disgust 0
смакували	                                   смакувати                                                                        verb:past:p:imperf  joy 84 sadness 0 anger 0 fear 0 amazement 0 disgust 0
вони	                                                     вони                                                                                 pron:pers:p:3:v_naz:anim joy 0 sadness 0 anger 0 fear 0 amazement 0 disgust 0
легкі	                                                     легкий                                                                              adj:p:v_naz:compb  joy 61 sadness 0 anger 0 fear 0 amazement 0 disgust 0
і	                                                      і                                                                                        conj:coord  joy 2 sadness 0 anger 0 fear 0 amazement 0 disgust 0
надзвичайно	                                   надзвичайно                                                                      adv  joy 71 sadness 0 anger 0 fear 0 amazement 0 disgust 0
смачні	                                                   смачний                                                                             adj:p:v_naz:compb  joy 87 sadness 0 anger 0 fear 0 amazement 0 disgust 0
кожна	                                                      кожний                                                                                  pron:def                                       (pron:def:f:s:v_naz) joy 0 sadness 0 anger 0 fear 0 amazement 0 disgust 0
гривня	                                                      гривня                                                                                  noun:f:v_naz  joy 30 sadness 0 anger 0 fear 0 amazement 0 disgust 0
себе	                                                      себе                                                                                      pron:refl:m:v_rod  joy 0 sadness 0 anger 0 fear 0 amazement 0 disgust 0
виправдовує	                                      виправдовувати                                                                   verb:pres:s:3:imperf  joy 23 sadness 0 anger 0 fear 0 amazement 0 disgust 0
Вина	                                                     вина                                                                                       noun:p:v_naz  joy 60 sadness 0 anger 0 fear 0 amazement 0 disgust 0
вино                  joy 45 sadness 0 anger 0 fear 0 amazement 0 disgust 0
також	                                                     також                                                                                      adv  joy 0 sadness 0 anger 0 fear 0 amazement 0 disgust 0
дуже	                                                      дуже                                                                                       adv joy 60 sadness 0 anger 0 fear 0 amazement 0 disgust 0
сподобались	                                     сподобатися                                                                           verb:rev:past:p:perf  joy 75 sadness 0 anger 0 fear 0 amazement 0 disgust 0
Авжеж	                                                      авжеж                                                                                      part  joy 0 sadness 0 anger 0 fear 0 amazement 0 disgust 0
атмосфера	                                      атмосфера                                                                              noun:f:v_naz  joy 60 sadness 0 anger 0 fear 0 amazement 0 disgust 0
закладу	                                                      заклад                                                                                     noun:m:v_rod                             (noun:m:s:v_rod) joy 15 sadness 0 anger 0 fear 0 amazement 0 disgust 0
мала	                                                      мати                                                                                         verb:past:f:imperf  joy 0 sadness 0 anger 0 fear 0 amazement 0 disgust 0
велике	                                                      великий                                                                                   adj:n:v_zna:compb  joy 74 sadness 0 anger 0 fear 0 amazement 0 disgust 0
значення          	                                      значення                                                                                 noun:n:v_zna joy 60 sadness 0 anger 0 fear 0 amazement 0 disgust 0
Інтер'єр	                                                    інтер'єр                                                                                     noun:m:v_naz  joy 46 sadness 0 anger 0 fear 0 amazement 0 disgust 0
незабутній	                                   незабутній                                                                                 adj:m:v_naz joy 75 sadness 0 anger 0 fear 0 amazement 0 disgust 0
відчуття	                                                    відчуття                                                                                    noun:n:v_naz  joy 18 sadness 0 anger 0 fear 0 amazement 0 disgust 0
старого	                                                     старий                                                                                      adj:m:v_rod:compb  joy 0 sadness 44 anger 0 fear 0 amazement 0 disgust 0
закритого	                                     закритий                                                                                  adjp:pasv:past:m:v_rod:compb joy 0 sadness 44 anger 0 fear 54 amazement 0 disgust 0
клубу	                                                     клуб                                                                                          noun:m:v_rod joy 40 sadness 0 anger 0 fear 0 amazement 0 disgust 0
Офіціанти	                                    офіціант                                                                                     noun:p:v_naz:anim  joy 31 sadness 0 anger 0 fear 0 amazement 0 disgust 0
 та                                                                та                                                                                                conj:coord  joy 0 sadness 0 anger 0 fear 0 amazement 0 disgust 0
 бармен	                                                     бармен                                                                                       noun:m:v_naz:anim              (noun:m:s:v_naz:anim)  joy 56 sadness 0 anger 0 fear 0 amazement 0 disgust 0
привітні	                                                    привітний                                                                                    adj:p:v_naz:compb  joy 76 sadness 0 anger 0 fear 0 amazement 0 disgust 0
комунікабельні	                                     комунікабельний                                                                        adj:p:v_naz  joy 72 sadness 0 anger 0 fear 0 amazement 0 disgust 0
так	                                                       так                                                                                             adv joy 0 sadness 0 anger 0 fear 0 amazement 0 disgust 0
склалося	                                                       скластися                                                                                  verb:rev:past:n:perf  joy 0 sadness 0 anger 0 fear 0 amazement 0 disgust 0
що	                                                       що                                                                                               pron:int:rel:n:v_naz  joy 0 sadness 0 anger 0 fear 0 amazement 0 disgust 0
наш	                                                       наш                                                                                             pron:pos                                 (pron:pos:m:s:naz)   joy 0 sadness 0 anger 0 fear 0 amazement 0 disgust 0
столик	                                                       столик                                                                                        noun:m:v_naz                         ( noun:m:s:v_naz)   joy 16 sadness 0 anger 0 fear 0 amazement 0 disgust 0
обслуговував	                                    обслуговувати                                                                             verb:past:m:imperf  joy 31 sadness 0 anger 0 fear 0 amazement 0 disgust 0
менеджер	                                    менеджер                                                                                      noun:m:v_naz:anim                 (noun:m:s:v_naz:anim)  joy 43 sadness 0 anger 0 fear 0 amazement 0 disgust 0
просто	                                                     просто                                                                                            part  joy 0 sadness 0 anger 0 fear 0 amazement 0 disgust 0
було	                                                     бути                                                                                                verb:past:n:imperf  joy 0 sadness 0 anger 0 fear 0 amazement 0 disgust 0
чому	                                                     що                                                                                                    pron:int:rel                                                         joy 0 sadness 0 anger 0 fear 0 amazement 0 disgust 0
я	                                                     я                                                                                                       pron:pers:s:1:v_naz:anim joy 0 sadness 0 anger 0 fear 0 amazement 0 disgust 0
не	                                                     не                                                                                                     part   joy 0 sadness 0 anger 0 fear 0 amazement 0 disgust 0
дивуюся	                                                    дивуватися                                                                                      verb:rev:pres:s:1:imperf  joy 25 sadness 0 anger 0 fear 0 amazement 0 disgust 0
Ми	                                                  ми                                                                             pron:pers:p:1:v_naz:anim  joy 0 sadness 0 anger 0 fear 0 amazement 0 disgust 0
відчули	                                                 відчути                                                                      verb:past:p:perf  joy 36 sadness 0 anger 0 fear 0 amazement 0 disgust 0
те	                                                  той                                                                            pron:dem                                                  (pron:dem:n:s:v_naz)  joy 0 sadness 0 anger 0 fear 0 amazement 0 disgust 0
що	                                                 що                                                                               conj:subord  joy 0 sadness 0 anger 0 fear 0 amazement 0 disgust 0
клієнти	                                                клієнт                                                                        noun:p:v_naz:anim  joy 43 sadness 0 anger 0 fear 0 amazement 0 disgust 0
у	                                                 у                                                                                prep:rv_mis:v-u  joy 0 sadness 0 anger 0 fear 0 amazement 0 disgust 0
закладі	                                                заклад                                                                       noun:m:v_mis                                   (noun:m:s:v_mis)  joy 0 sadness 0 anger 0 fear 0 amazement 0 disgust 0
на	                                                на                                                                               prep:rv_mis  joy 0 sadness 0 anger 0 fear 0 amazement 0 disgust 0
першому	                                                перший                                                                       adj:n:v_mis joy 42 sadness 0 anger 0 fear 0 amazement 0 disgust 0
місці	                                                місце                                                                            noun:n:v_mis                                   (noun:n:s:v_mis)  joy 55 sadness 0 anger 0 fear 0 amazement 0 disgust 0
це	                                                  цей                                                                             pron:dem                                            (pron:dem:n:s:v_naz) joy 0 sadness 0 anger 0 fear 0 amazement 0 disgust 0
надзвичайне	                                 надзвичайний                                                             adj:n:v_naz  joy 62 sadness 0 anger 0 fear 0 amazement 0 disgust 0
і	                                                        і                                                                              conj:coord  joy 0 sadness 0 anger 0 fear 0 amazement 0 disgust 0
досить	                                                   досить                                                                        adv  joy 0 sadness 0 anger 0 fear 0 amazement 0 disgust 0
рідке	                                                  рідкий                                                                           adj:n:v_naz:compb                             joy 19 sadness 0 anger 0 fear 0 amazement 0 disgust 0
                                                                                                                                                        joy 0 sadness 0 anger 0 fear 0 amazement 0 disgust 0
на	                                                  на                                                                                   prep:rv_zna  joy 0 sadness 0 anger 0 fear 0 amazement 0 disgust 0
наш	                                                  наш                                                                                 pron:pos                                       (pron:pos:m:s:v_naz) joy 0 sadness 0 anger 0 fear 0 amazement 0 disgust 0
час	                                                   час                                                                                noun:m:v_zna  joy 26 sadness 0 anger 0 fear 0 amazement 0 disgust 0
явище	                                                  явище                                                                              noun:n:v_naz  joy 49 sadness 0 anger 0 fear 0 amazement 0 disgust 0
Надрукувала	                                 надрукувати                                                                  verb:past:f:perf  joy 27 sadness 0 anger 0 fear 0 amazement 0 disgust 0
багато	                                                 багато                                                                             adv  joy 27 sadness 0 anger 0 fear 0 amazement 0 disgust 0
але	                                                  але                                                                                    conj:coord  joy 0 sadness 0 anger 0 fear 0 amazement 0 disgust 0
вилила	                                                  вилити                                                                              verb:past:f:perf  joy 0 sadness 29 anger 0 fear 0 amazement 0 disgust 0
всі	                                                   весь                                                                                  pron:dem                                   ( pron:dem:p:v_zna) joy 0 sadness 0 anger 0 fear 0 amazement 0 disgust 0
свої	                                                   свій                                                                                   pron:pos                                     ( pron:pos:p:v_zna) joy 0 sadness 0 anger 0 fear 0 amazement 0 disgust 0
емоції	                                                   емоція                                                                                noun:p:v_zna joy 59 sadness 0 anger 0 fear 0 amazement 0 disgust 0
та	                                                    та                                                                                       conj:coord  joy 0 sadness 0 anger 0 fear 0 amazement 0 disgust 0
думки	                                                   думка                                                                                  noun:p:v_zna joy 40 sadness 0 anger 0 fear 0 amazement 0 disgust 0
Я	                                                     я                                                                                       pron:pers:s:1:v_naz:anim  joy 0 sadness 0 anger 0 fear 0 amazement 0 disgust 0
вважаю	                                                вважати                                                                                verb:pres:s:1:imperf   joy 19 sadness 0 anger 0 fear 0 amazement 0 disgust 0
що	                                                  що                                                                                        pron:int:rel:n:v_naz  joy 0 sadness 0 anger 0 fear 0 amazement 0 disgust 0
ресторація	                                ресторація                                                                             noun:f:v_naz  joy 47 sadness 0 anger 0 fear 0 amazement 0 disgust 0
це	                                                 цей                                                                                        pron:dem                                             (pron:dem:n:s:v_naz) joy 0 sadness 0 anger 0 fear 0 amazement 0 disgust 0
те	                                                той                                                                                          pron:dem                                              (pron:dem:n:s:v_naz) joy 0 sadness 0 anger 0 fear 0 amazement 0 disgust 0
місце	                                                 місце                                                                                       noun:n:v_naz                                         (noun:n:s:v_naz)  joy 44 sadness 0 anger 0 fear 0 amazement 0 disgust 0
куди	                                                 куди                                                                                        adv   joy 0 sadness 0 anger 0 fear 0 amazement 0 disgust 0
необхідно	                                 необхідно                                                                                adv:compb  joy 25 sadness 0 anger 0 fear 0 amazement 0 disgust 0
сходити	                                                 сходити                                                                                   verb:inf:perf  joy 16 sadness 0 anger 0 fear 0 amazement 0 disgust 0
 у	                                                  у                                                                                             prep:rv_mis:v-u  joy 0 sadness 0 anger 0 fear 0 amazement 0 disgust 0
Львові	                                                 Львів                                                                                       noun:m:v_mis  joy 45 sadness 0 anger 0 fear 0 amazement 0 disgust 0
Дух	                                                 дух                                                                                           noun:m:v_naz                                  (noun:m:s:v_naz)  joy 30 sadness 0 anger 0 fear 0 amazement 0 disgust 0
міста	                                                  місто                                                                                        noun:n:v_rod                                  (noun:n:s:v_rod)     joy 30 sadness 0 anger 0 fear 0 amazement 0 disgust 0
відчувається	                                 відчуватися                                                                              verb:rev:pres:s:3:imperf joy 47 sadness 0 anger 0 fear 0 amazement 0 disgust 0
